丟	三 厶
並	丷 亚	丷 一 业
么	丿 厶
乗	禾 艹 一
乾	十 日 十 乞
亂	爪 龴 冂 厶 又 乙	爫 龴 冂 厶 又 乚
亙	万 丶 丶 一	二 彑 丶
亜	二 口 丨 丨
亞	二 □
仝	人 工
伨	人 勻	亻 勻
佇	人 宁	亻 宁
佈	人 布	亻 布
併	人 并	亻 并	人 幷	亻 幷
來	木 人 人	一 人 人 丨 人
侖	人 一 冊
価	人 西	亻 西
侶	人 呂	亻 呂
俁	人 吳	亻 吳
係	人 系	亻 系
俓	人 巠	亻 巠
俔	人 見	亻 見
俠	人 夾	亻 夾
俥	人 車	亻 車
俴	人 戔	亻 戔
俹	人 亞	亻 亞
倀	人 長	亻 長
倂	人 幷	亻 幷
倆	人 兩	亻 兩
倈	人 來	亻 來
倉	人 尸 一 口
個	人 固	亻 固
們	人 門	亻 門
倖	人 幸	亻 幸
倫	人 侖	亻 侖
倲	人 東	亻 東
倹	人 人 一 口 人	亻 人 一 口 人
偉	人 韋	亻 韋
偑	人 風	亻 風
偩	人 負	亻 負
側	人 則	亻 則
偵	人 貞	亻 貞
偸	人 兪	亻 兪
偽	人 為	亻 為
傊	人 員	亻 員
傑	人 桀	亻 桀
傖	人 倉	亻 倉
傘	人 人 人 人 十
備	人 草 厂 用	亻 艹 厂 用	亻 井 厂 用
傜	人 月 缶	亻 月 缶	人 䍃	亻 䍃
傠	人 討	亻 討
傢	人 家	亻 家
傪	人 參	亻 參
傭	人 庸	亻 庸
傱	人 從	亻 從
傳	人 專	亻 專
傴	人 區	亻 區
債	人 責	亻 責
傷	人 丿 一 昜	亻 丿 一 昜	人 丿 一 日 一 勿
傾	人 頃	亻 頃
僀	人 帶	亻 帶
僂	人 婁	亻 婁
僅	人 堇	亻 堇
僆	人 連	亻 連
僉	人 一 口 口 人 人
僋	人 貪	亻 貪
働	人 動	亻 動
僑	人 喬	亻 喬
僓	人 貴	亻 貴
僕	人 菐	亻 菐
僗	人 勞	亻 勞
僞	人 爲	亻 爲
僟	人 幾	亻 幾
僤	人 單	亻 單
僥	人 堯	亻 堯
僨	人 賁	亻 賁
僩	人 閒	亻 閒
僫	人 惡	亻 惡
僱	人 雇	亻 雇
僴	人 間	亻 間
僶	人 黽	亻 黽
價	人 賈	亻 賈
僾	人 愛	亻 愛
儀	人 義	亻 義
儂	人 農	亻 農
億	人 意	亻 意
儅	人 當	亻 當
儈	人 會	亻 會
儉	人 僉	亻 僉
儍	人 凶 丶 丶 丶 丶 八 夕	亻 凶 丶 丶 丶 丶 八 夂
儎	人 載	亻 載
儐	人 賓	亻 賓
儑	人 日 幺 幺 火	亻 日 幺 幺 灬	人 㬎	亻 㬎
儓	人 臺	亻 臺
儔	人 壽	亻 壽
儕	人 齊	亻 齊
儖	人 監	亻 監
儘	人 盡	亻 盡
儚	人 夢	亻 夢
儜	人 寧	亻 寧
儝	人 榮	亻 榮
儞	人 爾	亻 爾
償	人 賞	亻 賞
儢	人 慮	亻 慮
儣	人 廣	亻 廣
儥	人 賣	亻 賣
儧	人 賛	亻 賛
儨	人 質	亻 質
儩	人 賜	亻 賜
優	人 憂	亻 憂
儬	人 靚	亻 靚
儭	人 親	亻 親
儮	人 歷	亻 歷
儯	人 駦	亻 駦
儰	人 蒍	亻 蒍
儱	人 龍	亻 龍
儲	人 諸	亻 諸
儷	人 麗	亻 麗
儸	人 羅	亻 羅
儹	人 贊	亻 贊
儺	人 難	亻 難
儻	人 黨	亻 黨
儼	人 嚴	亻 嚴
兇	凶 儿
兊	公 儿	八 允
兌	八 兄	八 口 儿
兎	丿 丨 口 儿 丶
兒	臼 儿
兤	光 廣
內	冂 入
兩	一 冂 丨 入 入
兪	入 一 肉 巜	入 一 月 巜
兿	丷 一 执 云
円	冂 丄
冊	冂 一 丨 丨
冪	冖 幕
凈	冰 爭	冫 爭
凍	冰 東	冫 東
凒	冰 豈	冫 豈
凔	冰 倉	冫 倉
凙	冰 睪	冫 睪
凜	冰 稟	冫 稟
凟	冰 賣	冫 賣
処	夕 几	夂 几
凱	豈 几
凴	馮 几
別	口 刀 刀	口 刀 刀 刂
刦	去 刀	去 刂
刧	去 刀
刪	冊 刀	冊 刂
刴	朶 刀	朶 刂
刼	去 刃
剄	巠 刀	巠 刂
則	貝 刀	貝 刂
剋	克 刀	克 刂
剎	乂 丶 木 刀	乂 丶 木 刂
剗	戔 刀	戔 刂
剛	岡 刀	岡 刂
剝	彔 刀	彔 刂
剣	人 一 口 人 刀	人 一 口 人 刂
剤	斉 刀	斉 刂
剮	咼 刀	咼 刂
剰	乗 刀	乗 刂
剱	人 一 口 人 刄
剴	豈 刀	豈 刂
創	倉 刀	倉 刂
剸	專 刀	專 刂
剼	參 刀	參 刂
剾	區 刀	區 刂
劃	畫 刀	畫 刂
劇	豦 刀	豦 刂
劉	卯 金 刀	卯 金 刂
劊	會 刀	會 刂
劌	歲 刀	歲 刂
劍	僉 刀	僉 刂
劎	僉 刀
劏	當 刀	當 刂
劑	齊 刀	齊 刂
劒	僉 刃
劔	僉 刄
劕	質 刀	質 刂
劗	贊 刀	贊 刂
劚	屬 刀	屬 刂
労	小 冖 力
勁	巠 力
勑	來 力
動	重 力
務	矛 务	矛 夂 力
勛	員 力
勝	肉 劵	月 劵	月 丷 夫 力
勞	𤇾 力	𤇾 力
勢	埶 力	執 力
勣	責 力
勥	強 力
勧	丿 二 隹 力
勩	貰 力
勪	喬 力
勱	萬 力
勴	慮 力
勵	厲 力
勸	雚 力
勻	勹 二
匘	匕 巛 囟	匕 𡿺
匨	匚 壯
匭	匚 軌
匯	匚 淮
匰	匚 單
匱	匚 貴
匳	匚 僉
匵	匚 賣
匶	匚 舊
區	匸 品	匚 品
協	十 劦
卛	絲 言 十	糸 言 糸 十	䜌 十
卨	卜 咼
卻	谷 卩
卽	白 匕 卩
厙	厂 車
厛	厂 听
厭	厂 猒
厱	厂 僉
厲	厂 萬
厳	小 厂 敢
厴	厭 甲	厂 猒 甲
參	厽 人 彡	厶 厶 厶 人 彡
叄	厽 人 三	厶 厶 厶 人 三
叢	丵 取	业 丷 二 丨 取	业 羊 取
吒	口 宅
吳	口 ㇉ 大
吶	口 內
呂	口 丶 口
呉	口 ㇉ 一 八
呑	夭 口
咼	冎 口	冂 ㇆ 冂 口
員	口 貝
哯	口 見
唄	口 貝
唊	口 夾
唓	口 車
唖	口 亜
唸	口 念
唻	口 來
問	門 口
啓	戶 攴 口	戶 攵 口
啞	口 亞
啟	戶 口 攴	戶 口 攵
啢	口 兩
啺	口 昜
喆	吉 吉
喎	口 咼
喗	口 軍
喚	口 奐
喞	口 卽
喡	口 韋
喪	土 口 口 □
喬	夭 口 冂 口
單	口 口 甲 一
喲	口 約
営	小 冖 呂
喺	口 係
嗂	口 月 缶	口 䍃
嗆	口 倉
嗇	土 人 人 回	土 人 人 囗 口
嗊	口 貢
嗎	口 馬
嗚	口 烏
嗩	口 小 貝
嗰	口 個
嗶	口 畢
嗹	口 連
嗿	口 貪
嘄	口 梟
嘆	口 革 大
嘇	口 參
嘍	口 婁
嘓	口 國
嘔	口 區
嘖	口 責
嘗	尚 旨
嘜	口 麥
嘨	口 粛
嘩	口 華
嘪	口 買
嘮	口 勞
嘯	口 肅
嘰	口 幾
嘳	口 貴
嘵	口 堯
嘸	口 無
嘺	口 喬
嘽	口 單
噁	口 惡
噅	口 為
噓	口 虛
噕	爲 口
噚	口 尋
噛	口 歯
噝	口 絲
噞	口 僉
噠	口 達
噥	口 農
噦	口 歲
噧	口 萬
噯	口 愛
噲	口 會
噴	口 賁
噸	口 頓
噹	口 當
嚀	口 寧
嚂	口 監
嚇	口 赫
嚈	口 厭
嚉	口 對
嚋	口 壽
嚌	口 齊
嚍	口 盡
嚐	口 嘗
嚔	口 十 冖 田 厶 卜 人
嚕	口 魯
嚙	口 齒
嚛	口 樂
嚝	口 廣
嚠	口 劉
嚥	口 燕
嚦	口 歷
嚧	口 盧
嚨	口 龍
嚩	口 縛
嚪	口 閻
嚫	口 親
嚬	口 頻
嚮	鄉 向
嚱	口 戲
嚲	享 單
嚳	臼 爻 冖 告	𦥯 告
嚴	口 口 厂 敢
嚶	口 嬰
嚸	口 點
嚻	口 口 頁 口 口	吕 頁 吕
嚽	口 贅
嚿	口 舊
囀	口 轉
囁	口 聶
囂	口 口 頁 口 口
囄	口 離
囅	單 展
囆	口 蠆
囇	口 麗
囈	口 藝
囉	口 羅
囋	口 贊
囌	口 蘇
囐	口 獻
囑	口 屬
囒	口 蘭
囓	口 齧	口 丰 刀 齒
囘	冂 巳	冂 已
囬	囗 丨 丨 一 一
囲	囗 井
図	囗 乂 丶 丶
圇	囗 侖
國	囗 或
圍	囗 韋
圎	囗 貟
圏	囗 卷
園	囗 袁
圓	囗 員
圖	囗 啚
團	囗 專
圚	囗 貴
圛	囗 睪
圝	囗 絲 言	囗 糸 言 糸	囗 䜌
圞	囗 欒
圧	厂 土
均	土 勻
垜	土 朶
垷	土 見
垻	土 貝
埉	土 夾
埡	土 亞
埨	土 侖
埩	土 爭
埬	土 東
執	幸 丸
堃	方 方 土
堅	臤 土
堈	土 岡
堊	亞 土
堖	土 巛 丶 囗 乂
堚	土 軍
堝	土 咼
堯	垚 兀
報	幸 卩 又
場	土 昜
堸	土 風
塊	土 鬼
塋	火 火 冖 土	𤇾 土
塏	土 豈
塒	土 時
塗	涂 土	水 余 土
塡	土 眞
塢	土 烏
塤	土 員
塦	陣 土
塩	土 土 丿 一 口 皿
塲	土 人 丿 一 昜
塵	鹿 土
塷	土 鹵
塸	土 區
塹	斬 土
塼	土 專
塿	土 婁
墆	土 帶
墊	執 土
墋	土 參
墏	將 土
増	土 曽
墜	隊 土
墝	土 堯
墟	土 虛
墠	土 單
墢	土 發
墣	土 菐
墤	土 貴
墧	土 喬
墮	隋 土
墲	土 無
墳	土 賁	土 十 十 十 貝	土 十 艹 貝
墴	土 黃
墵	土 雲
墶	土 達
墷	土 華
墻	土 嗇
墼	車 凵 殳 土
墾	豸 艮 土
墿	土 睪
壇	土 亶
壈	土 稟
壊	土 十 目 衣	土 十 网 衣	土 十 罒 衣
壋	土 當
壍	漸 土
壏	土 監
壐	爾 土
壓	厭 土
壔	土 壽
壘	畾 土	田 田 田 土
壙	土 廣
壚	土 盧
壜	土 曇
壝	土 遺
壞	土 褱
壟	土 龍
壠	土 龍
壢	土 歷
壣	土 聯
壧	土 嚴
壩	土 霸
壯	爿 士
売	士 冖 儿
壷	士 冖 亜
壺	士 冖 □	士 冖 亞
壼	士 冖 亞
壽	士 乛 工 一 口 寸
変	亦 夂
夠	多 句
夢	草 网 冖 夕	艸 网 冖 夕	艹 罒 冖 夕
夥	果 多
夾	大 人 人
奐	刀 冂 儿 大
奧	丶 冂 采 大	丶 冂 釆 大
奨	将 大
奩	大 區
奪	大 隹 寸
奫	大 淵
奮	大 隹 田
奱	絲 言 大	糸 言 糸 大	䜌 大
奲	奢 單
妝	爿 女
妳	女 尔
姍	女 冊
姦	女 女 女
娊	女 見
娙	女 巠
娛	女 吳
娤	壯 女
娯	女 呉
娻	女 東
婁	口 十 口 女	口 一 中 女
婜	臣 又 女
婡	女 來
婦	女 彐 冖 巾
婨	女 侖
婭	女 亞
婸	女 昜
媁	女 韋
媍	女 負
媜	女 貞
媧	女 咼
媯	女 為
媰	女 芻
媱	女 月 缶	女 䍃
媵	肉 丷 夫 女	月 𠔉 女	肉 𠔉 女	月 𠔉 女
媼	女 昷
媽	女 馬
嫈	火 火 冖 女	𤇾 女
嫗	女 區
嫢	規 女
嫥	女 專
嫧	女 責
嫵	女 無
嫺	女 閒
嫻	女 閑
嫿	女 畫
嬀	女 爲
嬂	女 戠
嬃	須 女
嬇	女 貴
嬈	女 堯
嬋	女 單
嬌	女 喬
嬐	女 僉
嬒	女 會
嬕	女 睪
嬙	女 嗇
嬝	女 裊
嬟	女 義
嬡	女 愛
嬢	女 六 井 一 
嬣	女 寧
嬤	女 麻 幺
嬦	女 壽
嬧	女 盡
嬩	女 與
嬪	女 賓
嬭	女 爾
嬮	厭 女
嬯	女 臺
嬰	貝 貝 女
嬱	漸 女
嬵	女 綿
嬸	女 審
嬹	女 興
嬻	女 賣
嬼	女 劉
嬾	女 賴
孃	女 襄
孄	女 闌
孆	女 嬰
孇	女 雙
孈	女 巂
孋	女 麗
孌	絲 言 女	糸 言 糸 女	䜌 女
孍	女 嚴
孎	女 屬
孏	女 蘭
孫	子 系
孭	子 貝
孯	臣 又 子
孲	子 亞
孶	茲 子
學	臼 爻 冖 子	𦥯 子
孻	子 盡
孾	子 嬰
孿	絲 言 子	糸 言 糸 子	䜌 子
実	宀 二 大
宮	宀 呂	宀 口 丶 口
寊	宀 貞
寛	宀 草 見	宀 艸 見	宀 艹 見
寜	宀 心 皿 亅
寠	宀 婁
寢	宀 爿 彐 冖 又
實	宀 貫
寧	宀 心 皿 丁
審	宀 番
寪	宀 為
寫	宀 舄
寬	宀 草 見 丶	宀 艸 見 丶	宀 艹 見 丶
寳	宀 王 尔 貝
寴	宀 親
寵	宀 龍
寶	宀 王 缶 貝	宀 玉 缶 貝
対	文 寸
専	一 由 寸
將	爿 肉 寸	爿 月 寸	爿 夕 寸
專	叀 寸	一 由 厶 寸
尋	彐 工 口 寸
對	业 羊 寸
導	道 寸
尙	小 冋	小 冂 口
尭	卉 兀
尵	尢 貴
尶	兀 監
尷	尢 監
屆	尸 凵 士
屍	尸 死
屓	尸 貝
屛	尸 幷
屜	尸 彳 世
屢	尸 婁
層	尸 曽	尸 曾
屨	尸 彳 婁
屩	尸 彳 喬
屫	尸 爿 喬
屬	尸 二 丨 二 蜀
屭	尸 贔
岡	冂 丷 一 山
峩	山 我
峴	山 見
島	丶 彐 一 勹 山
峽	山 夾
崍	山 來
崑	山 昆
崗	山 岡
崘	山 侖
崙	山 侖
崠	山 東
崢	山 爭
崬	山 東
崱	山 則
崵	山 昜
崸	山 頁
嵐	山 風
嵦	山 豈
嵨	山 烏
嵪	山 高
嵷	山 從
嵸	山 從
嵼	山 產
嵽	山 帶
嵾	山 參
嵿	山 頂
嶁	山 婁
嶃	山 斬
嶄	山 斬
嶇	山 區
嶈	山 將
嶋	山 島
嶌	山 島
嶔	山 欽
嶗	山 勞
嶘	山 棧
嶠	山 喬
嶢	山 堯
嶤	山 堯
嶧	山 睪
嶨	臼 爻 冖 山	𦥯 山
嶩	山 農
嶪	山 業
嶫	山 業
嶬	山 義
嶮	山 僉
嶲	山 雋
嶴	奧 山
嶸	山 榮
嶹	山 壽
嶺	山 領
嶼	山 與
嶽	山 獄
嶾	山 爪 工 彐 心	山 爫 工 彐 心	山 㥯
巁	山 厲
巃	山 龍
巄	山 龍
巆	山 營
巇	山 戲
巊	山 嬰
巋	山 歸
巌	山 厳
巑	山 贊
巒	絲 言 山	糸 言 糸 山	䜌 山
巔	山 顛
巖	山 嚴
巗	山 嚴
巘	山 獻
巚	山 獻
巣	小 果	丶 丶 丶 果
巰	巠 亠 厶 川	巠 巟	巠 㐬
巻	丷 夫 己	𠔉 㔾
帥	戶 乛 一 巾	户 乛 一 巾
帨	巾 兌
師	戶 乛 一 帀	户 乛 一 帀
帲	巾 幷
帳	巾 長
帴	巾 戔
帶	廿 丿 乚 冖 巾
幀	巾 貞
幁	巾 頁
幃	巾 韋
幇	封 巾
幊	巾 貢
幓	巾 參
幗	巾 國
幘	巾 責
幝	巾 單
幟	巾 戠
幠	巾 無
幣	敝 巾
幩	巾 賁
幫	封 帛
幬	巾 壽
幯	巾 節
幰	巾 憲
幱	巾 闌
幹	十 日 十 人 干
幾	幺 幺 戈 人	幺 幺 戍
庁	广 丁
広	广 厶
庫	广 車
庲	广 來
廁	广 則
廂	厂 相
廃	广 発
廄	广 艮 殳
廈	广 夏
廎	广 頃
廔	广 婁
廕	广 陰
廗	广 帶
廙	广 異
廚	广 尌	广 士 豆 寸
廝	厂 斯
廞	广 欽
廟	广 朝	广 由
廠	广 敞
廡	广 無
廢	广 發
廣	广 黃
廥	广 會
廧	广 嗇
廩	广 稟
廫	广 膠
廬	广 盧
廮	广 嬰
廯	广 鮮
廰	广 聴
廲	广 麗
廳	广 聽
廼	廴 西
廽	廴 囬
弉	壯 廾
弒	杀 式
弔	弓 丨
弳	弓 巠
張	弓 長
強	弓 厶 蟲	弓 厶 虫
弾	弓 単
彃	弓 畢
彄	弓 區
彆	敝 弓
彇	弓 肅
彈	弓 單
彌	弓 爾
彍	弓 廣
彎	絲 言 弓	糹 言 糹 弓	䜌 弓
彔	彑 水
彙	彑 冖 果
彜	彑 米 分 廾
彞	彐 米 糸 廾
彠	尋 蒦
彥	文 厂 彡
彫	周 彡
彲	麗 彡
彷	彳 方
後	彳 幺 夂	彳 幺 夕
徑	彳 巠
従	彳 丷 一 卜 人 	彳 丷 下 人 
從	彳 人 人 疋
徠	彳 來
復	彳 复
徫	彳 韋
徭	彳 月 缶	彳 䍃
徳	彳 十 目 心	彳 十 网 心	彳 十 罒 心
徵	彳 山 一 王 攴	彳 山 一 王 攵
徹	彳 育 攵
徺	彳 堯
徻	彳 會
徿	彳 龍
応	广 心
忥	氣 心	气 心
恆	心 亙	忄 亙
恥	耳 心
恵	一 由 心
悅	心 兌	忄 兌
悏	心 夾	忄 夾
悓	心 見	忄 見
悞	心 吳	忄 吳
悩	心 小 乂 凵	忄 小 乂 凵
悪	亜 心
悵	心 長	忄 長
悶	門 心
惀	心 侖	忄 侖
惡	亞 心
惱	心 巛 囟	忄 巛 囟	心 𡿺	忄 𡿺
惲	心 軍	忄 軍
惻	心 則	忄 則
愇	心 韋	忄 韋
愌	心 奐	忄 奐
愓	心 昜	忄 昜
愛	爪 冖 心 夂	爫 冖 心 夂
愜	心 匧	忄 匧
愩	心 貢	忄 貢
愪	心 員	忄 員
愮	心 月 缶	忄 月 缶	心 䍃	忄 䍃
愴	心 倉	忄 倉
愷	心 豈	忄 豈
愸	勑 心
愻	孫 心
愼	心 眞	忄 眞
愾	心 氣	忄 氣
慂	涌 心
慄	心 栗	忄 栗
態	能 心
慍	心 囚 皿	忄 囚 皿
慖	心 國	忄 國
慘	心 參	忄 參
慙	斬 心
慚	心 斬	忄 斬
慟	心 動	忄 動
慣	心 貫	忄 貫
慤	壳 殳 心	殼 心
慩	心 連	忄 連
慪	心 區	忄 區
慫	從 心
慮	虎 思 心	虍 思 心
慯	心 丿 一 昜	忄 丿 一 昜
慱	心 專	忄 專
慲	心 廿 冂 丨 入 入	忄 廿 冂 丨 入 入	心 㒼	忄 㒼
慳	心 堅	忄 堅
慶	广 乛 一 丨 丨 乛 心 夕	广 乛 一 丨 丨 乛 心 夂
慸	帶 心
慹	執 心
慺	心 婁	忄 婁
慾	欲 心
憂	一 白 冖 心 夕	一 白 冖 心 夂
憈	心 虛	忄 虛
憊	備 心
憌	鈞 心
憍	心 喬	忄 喬
憐	心 粦	忄 粦
憑	馮 心
憒	心 貴	忄 貴
憖	猌 心
憗	心 來 攴	來 攵
憚	心 單	忄 單
憢	心 堯	忄 堯
憤	心 賁	忄 賁	心 十 十 十 貝	忄 十 十 十 貝
憥	勞 心
憦	心 勞	忄 勞
憪	心 閒	忄 閒
憫	心 閔	忄 閔
憮	心 無	忄 無
憲	宀 丰 网 心	宀 丰 罒 心
憳	心 尋	忄 尋
憴	心 黽	忄 黽
憶	心 意	忄 意
憸	心 僉	忄 僉
憹	心 農	忄 農
懇	豸 艮 心
應	广 人 隹 心	广 亻 隹 心	广 倠 心
懊	心 奧
懌	心 睪	忄 睪
懍	心 稟	忄 稟
懎	心 嗇	忄 嗇
懐	心 十 目 衣	忄 十 网 衣	忄 十 罒 衣
懓	心 愛	忄 愛
懕	厭 心
懖	銛 心
懘	滯 心
懙	心 與	忄 與
懚	心 爪 工 彐 心	忄 爫 工 彐 心	心 㥯	忄 㥯
懛	心 臺	忄 臺
懜	心 夢	忄 夢
懟	對 心
懠	心 齊	忄 齊
懡	心 麽	忄 麽
懢	心 監	忄 監
懣	滿 心
懧	心 寧	忄 寧
懨	心 厭	忄 厭
懫	心 質	忄 質
懬	廣 心
懭	心 廣	忄 廣
懰	心 劉	忄 劉
懲	徴 心
懴	心 韯	忄 韯
懶	心 賴	忄 賴
懷	心 褱	忄 褱
懸	縣 心
懺	心 韱	忄 韱
懼	心 瞿	忄 瞿
懾	心 聶	忄 聶
戀	絲 言 心	糸 言 糸 心	䜌 心
戁	難 心
戃	心 黨	忄 黨
戅	贑 心
戇	立 早 攴 頁 心	立 早 攵 頁 心
戔	戈 戈
戝	貝 戈
戦	单 丶 戈
戧	倉 戈
戩	晉 戈
戰	單 戈
戱	虛 戈
戲	虎 豆 戈	虍 豆 戈
戶	丿 尸	一 尸 戸
戹	戶 乙
戺	戶 巳
戻	戶 大
戽	戶 斗
扂	戶 占
扃	戶 冋
扄	戶 向
扅	戶 多
扆	戶 衣
扉	戶 非
扊	戶 炎
払	手 厶	扌 厶	才 厶
抐	手 內	扌 內	才 內
択	手 尺	扌 尺	才 尺
拋	手 尢 力	扌 尢 力	才 尢 力
拝	手 手	扌 手	才 手
拡	手 広	扌 広	才 広
挅	手 朶	扌 朶	才 朶
挩	手 兌	扌 兌	才 兌
挳	手 巠	扌 巠	才 巠
挸	手 見	扌 見	才 見
挾	手 夾	扌 夾	才 夾
捙	手 車	扌 車	才 車
捛	手 呂	扌 呂	才 呂
捨	手 舍	扌 舍	才 舍
捫	手 門	扌 門	才 門
捱	手 厓	扌 厓	才 厓
捴	手 忩	扌 忩	才 忩
掁	手 長	扌 長	才 長
掃	手 帚	扌 帚	才 帚
掄	手 侖	扌 侖	才 侖
掆	手 岡	扌 岡	才 岡
掔	臣 又 手
掗	手 亞	扌 亞	才 亞
掙	手 爭	扌 爭	才 爭
掚	手 兩	扌 兩	才 兩
掛	手 卦	扌 卦	才 卦
採	手 采	扌 采	才 采
掻	手 又 蟲	扌 又 虫	才 又 虫
揀	手 柬	扌 柬	才 柬
揁	手 貞	扌 貞	才 貞
揔	手 怱	扌 怱	才 怱
揚	手 昜	扌 昜	才 昜
換	手 奐	扌 奐	才 奐
揮	手 軍	扌 軍	才 軍
揯	手 恆	扌 恆	才 恆
揹	手 背	扌 背	才 背
損	手 員	扌 員	才 員
搎	手 孫	扌 孫	才 孫
搖	手 月 缶	扌 月 缶	才 月 缶	手 䍃	扌 䍃	才 䍃
搗	手 島	扌 島	才 島
搟	手 軒	扌 軒	才 軒
搢	手 晉	扌 晉	才 晉
搥	手 追	扌 追	才 追
搵	手 昷	扌 昷	才 昷
搶	手 倉	扌 倉	才 倉
摀	手 烏	扌 烏	才 烏
摂	手 耳 丷 八	扌 耳 丷 八	才 耳 丷 八
摃	手 貢	扌 貢	才 貢
摋	手 殺	扌 殺	才 殺
摌	手 產	扌 產	才 產
摑	手 國	扌 國	才 國
摕	手 帶	扌 帶	才 帶
摙	手 連	扌 連	才 連
摜	手 貫	扌 貫	才 貫
摟	手 婁	扌 婁	才 婁
摠	手 悤	扌 悤	才 悤
摥	手 丿 一 昜	扌 丿 一 昜	才 丿 一 昜
摪	手 將	扌 將	才 將
摫	手 規	扌 規	才 規
摯	執 手
摰	埶 手
摲	手 斬	扌 斬	才 斬
摳	手 區	扌 區	才 區
摶	手 專	扌 專	才 專
摺	手 習	扌 習	才 習
摻	手 參	扌 參	才 參
摼	手 堅	扌 堅	才 堅
撁	手 牽	扌 牽	才 牽
撃	車 殳 手
撈	手 勞	扌 勞	才 勞
撊	手 閒	扌 閒	才 閒
撋	手 閏	扌 閏	才 閏
撌	手 貴	扌 貴	才 貴
撏	手 尋	扌 尋	才 尋
撐	手 牚	扌 牚	才 牚	手 尚 牙
撓	手 堯	扌 堯	才 堯
撗	手 黃	扌 黃	才 黃
撝	手 爲	扌 爲	才 爲
撟	手 喬	扌 喬	才 喬
撣	手 單	扌 單	才 單
撥	手 發	扌 發	才 發
撧	手 絕	扌 絕	才 絕
撪	手 厶 大 車	扌 厶 大 車	才 厶 大 車
撫	手 無	扌 無	才 無
撲	手 菐	扌 菐	才 菐
撳	手 欽	扌 欽	才 欽
撹	手 覚	扌 覚	才 覚
撻	手 達	扌 達	才 達
撾	手 過	扌 過	才 過
撿	手 僉	扌 僉	才 僉
擁	手 雍	扌 雍	才 雍
擃	手 農	扌 農	才 農
擄	手 虜	扌 虜	才 虜
擆	手 著	扌 著	才 著
擇	手 睪	扌 睪	才 睪
擈	手 業	扌 業	才 業
擊	車 凵 殳 手
擋	手 當	扌 當	才 當
擌	手 筴	扌 筴	才 筴
擓	手 匯	扌 匯	才 匯
擔	手 詹	扌 詹	才 詹
擕	手 雋	扌 雋	才 雋
擙	手 奧	扌 奧	才 奧
據	手 豦	扌 豦	才 豦
擟	手 爾	扌 爾	才 爾
擠	手 齊	扌 齊	才 齊
擡	手 臺	扌 臺	才 臺
擣	手 壽	扌 壽	才 壽
擥	臣 丿 一 丶 网 手	臣 丿 一 丶 罒 手
擧	與 手
擪	厭 手
擫	手 厭	扌 厭	才 厭
擬	手 疑	扌 疑	才 疑
擯	手 賓	扌 賓	才 賓
擰	手 寧	扌 寧	才 寧
擱	手 閣	扌 閣	才 閣
擲	手 鄭	扌 鄭	才 鄭
擳	手 節	扌 節	才 節
擴	手 廣	扌 廣	才 廣
擷	手 頡	扌 頡	才 頡
擺	手 罷	扌 罷	才 罷
擻	手 數	扌 數	才 數
擼	手 魯	扌 魯	才 魯
擽	手 樂	扌 樂	才 樂
擾	手 憂	扌 憂	才 憂
擿	手 適	扌 適	才 適
攄	手 慮	扌 慮	才 慮
攅	手 賛	扌 賛	才 賛
攆	手 輦	扌 輦	才 輦
攇	手 憲	扌 憲	才 憲
攊	手 歷	扌 歷	才 歷
攋	手 賴	扌 賴	才 賴
攎	手 盧	扌 盧	才 盧
攏	手 龍	扌 龍	才 龍
攑	手 舉	扌 舉	才 舉
攔	手 闌	扌 闌	才 闌
攖	手 嬰	扌 嬰	才 嬰
攙	手 毚	扌 毚	才 毚
攛	手 竄	扌 竄	才 竄
攜	手 雟	扌 雟	才 雟
攝	手 聶	扌 聶	才 聶
攞	手 羅	扌 羅	才 羅
攡	手 離	扌 離	才 離
攢	手 贊	扌 贊	才 贊
攣	絲 言 手	糸 言 糸 手	䜌 手
攤	手 難	扌 難	才 難
攦	手 麗	扌 麗	才 麗
攧	手 顛	扌 顛	才 顛
攩	手 黨	扌 黨	才 黨
攪	手 覺	扌 覺	才 覺
攬	手 覽	扌 覽	才 覽
攳	支 尋
敎	乂 一 丿 子 攴	乂 一 丿 子 攵
敓	兌 攴	兌 攵
敗	貝 攴	貝 攵
敘	余 攴	余 攵
敳	豈 攴	豈 攵
敵	啇 攴	啇 攵
敶	陳 攴	陳 攵
數	婁 攴	婁 攵
敺	區 攴
敽	喬 攴
敿	喬 攴	喬 攵
斁	睪 攴	睪 攵
斂	僉 攴	僉 攵
斃	敝 死
斄	未 攵 厂 來
斅	學 攴
斆	學 攴	學 攵
斉	文 丿 二 丨
斍	文 見
斎	文 丿 二 小 丨
斔	文 蟲 臾	文 虫 臾
斕	文 闌
斬	車 斤
斷	丨 二 幺 幺 幺 幺 斤
斸	屬 斤
於	方 人 冫
旘	方 丿 一 戠
旟	方 丿 一 與
旤	咼 旡
日	口 一	囗 一	囗 丶
昈	日 戶
昿	日 広
時	日 寺
晉	一 厶 厶 一 日
晛	日 見
晝	聿 旦
晵	戶 攵 日
暁	日 尭
暈	日 軍
暉	日 軍
暊	日 頁
暐	日 韋
暘	日 昜
暟	日 豈
暢	申 昜
暣	日 氣
暪	日 廿 冂 丨 入 入	日 廿 冂 丨 入 入	日 㒼
暫	斬 日
暬	埶 日
暰	日 從
暱	日 匿
暷	日 專
曂	日 黃
曄	日 華
曅	日 華
曆	厂 禾 禾 日	厂 秝 日
曇	日 雲
曉	日 堯
曊	日 費
曎	日 睪
曏	日 鄉
曖	日 愛
曗	日 業
曞	日 厲
曠	日 廣
曥	日 盧
曨	日 龍
曪	日 羅
曫	絲 言 日	糸 言 糸 日	䜌 日
曬	日 麗
曭	日 黨
曮	日 嚴
曯	日 屬
書	聿 曰
會	人 一 口 丨 丷 曰
朄	申 柬
朇	會 卑
朢	臣 月 壬
朧	月 龍
朶	乃 木
東	木 日
枃	木 勻
枘	木 內
枱	木 台
柒	水 七 木
柵	木 冊
柺	木 口 刀	木 另
栄	小 冖 木
桜	木 小 女
桟	木 戈 二	木 戋 一
桱	木 巠
桿	木 旱
梉	木 壯
梖	木 貝
梘	木 見
梜	木 夾
條	攸 木
梟	鳥 木
梠	木 呂
梲	木 兌
棄	亠 厶 廿 木
棆	木 侖
棖	木 長
棗	朿 朿
棜	木 於
棟	木 東
棡	木 岡
棦	木 爭
棧	木 戔
棨	戶 攵 木
棩	木 片 一 爿
棲	木 妻
棶	木 來
椏	木 亞
検	木 人 一 口 人
椲	木 韋
楇	木 咼
楊	木 昜	木 日 一 勿
楎	木 軍
楓	木 風
楞	木 网 方	木 罒 方
楨	木 貞
業	业 丷 二 木
極	木 亟
楽	冰 白 丶 丶 木	冫 白 丶 丶 木
榗	木 晉
榣	木 月 缶	木 䍃
榪	木 馬
榮	火 火 冖 木	𤇾 木
榯	木 時
榲	木 囚 皿	木 昷
榿	木 豈
槂	木 孫
構	木 冓
槍	木 倉
槓	木 貢
様	木 羊 水
槤	木 連
槧	木 斬
槪	木 旣
槫	木 專
槮	木 參
槳	將 木
槶	木 國
槻	木 規
槼	木 規
樁	木 舂
樂	幺 白 幺 木
樄	木 陳
樅	木 從
樌	木 貫
樍	木 責
樐	木 鹵
樓	木 婁
標	木 票
樞	木 區
樠	木 廿 冂 丨 入 入	木 廿 冂 丨 入 入	木 㒼
樢	木 鳥
樣	木 羕
樤	木 條
樧	木 殺 丶
権	木 丿 二 隹
樫	木 堅
樲	木 貳
樳	木 尋
樴	木 戠
樸	木 菐
樹	木 尌
樺	木 華
樻	木 貴
樿	木 單
橁	木 筍
橃	木 發
橅	木 無
橈	木 堯
橋	木 喬
橌	木 閒
橍	木 閏
橒	木 雲
橕	木 牚
橚	木 肅
機	木 幾
橢	木 隋
橨	木 賁
橩	木 焭
橫	木 黃
橮	木 貿
橯	木 勞
橺	木 間
橽	木 達
檁	木 稟
檂	木 農
檃	爪 工 彐 木	爫 工 彐 木
檉	木 聖
檋	木 輂
檏	木 業
檒	林 風
檔	木 當
檛	木 過
檜	木 會
檟	木 賈
檡	木 睪
檢	木 僉
檣	木 嗇
檥	木 義
檭	木 銀
檮	木 壽
檯	木 臺
檰	木 綿
檳	木 賓
檶	木 奩
檷	木 爾
檸	木 寧
檻	木 監
檼	木 爪 工 彐 心	木 爫 工 彐 心	木 㥯
檾	火 火 冖 林	𤇾 林
櫃	木 匱
櫅	木 齊
櫇	木 頗
櫉	木 厂 尌
櫌	木 憂
櫍	木 質
櫎	木 廣
櫓	木 魯
櫔	木 厲
櫕	木 贊
櫖	木 慮
櫙	木 區
櫚	木 閭	木 門 呂
櫛	木 節
櫝	木 賣
櫞	木 緣
櫟	木 樂
櫠	木 廢
櫢	木 數
櫣	木 連
櫥	木 廚
櫧	木 諸
櫨	木 盧
櫩	木 閻
櫪	木 歷
櫫	木 豬
櫬	木 親
櫯	木 穌
櫳	木 龍
櫴	木 賴
櫶	木 憲
櫸	木 舉
櫹	木 蕭
櫻	木 嬰
櫽	隱 木
櫿	木 營
欁	林 農	木 農 木
欄	木 闌
欅	木 舉
欆	木 雙
欉	木 叢
權	木 雚
欏	木 羅
欐	木 麗
欑	木 贊
欒	絲 言 木	糸 言 糸 木	䜌 木
欓	木 黨
欖	木 覽
欘	木 屬
欛	木 霸
欞	木 靈
欽	金 欠	釒 欠
歍	烏 欠
歎	革 大 欠
歐	區 欠
歓	丿 二 隹 欠
歔	虛 欠
歕	賁 欠
歗	肅 欠
歛	僉 欠
歝	睪 欠
歞	日 幺 幺 火 欠	日 幺 幺 灬 欠	㬎 欠
歟	與 欠
歡	雚 欠
歯	止 米 凵
歲	止 戊 丁 丶 丿	止 戊 一 小
歳	止 戊 一 小
歵	止 責
歷	厂 禾 禾 止	厂 秝 止
歸	𠂤 止 帚
歿	歹 勹 又
殌	歹 巠
殎	歹 夾
殘	歹 戔
殞	歹 員
殤	歹 丿 一 昜
殦	歹 鳥
殨	歹 貴
殫	歹 單
殬	歹 睪
殭	歹 畺
殮	歹 僉
殯	歹 賓
殰	歹 賣
殲	歹 韱	歹 人 人 戈 韭
殺	杀 殳	乂 木 殳
殻	壳 殳
殼	壳 一 殳
毀	臼 土 殳
毄	車 口 殳
毆	區 殳
毊	殸 喬
毎	丿 一 毋
毿	參 毛
氀	婁 毛
氂	未 攴 厂 毛	未 攵 厂 毛
氈	亶 毛
氊	毛 亶
氌	毛 魯
氕	氣 丿	气 丿
氖	氣 乃	气 乃
気	氣 乂	气 乂
氘	氣 丿 丨	气 丿 丨
氙	氣 山	气 山
氚	氣 川	气 川
氛	氣 分	气 分
氜	氣 日	气 日
氝	氣 內	气 內
氟	氣 弗	气 弗
氠	氣 申	气 申
氡	氣 冬	气 冬
氣	氣 米	气 米
氤	氣 因	气 因
氥	氣 西	气 西
氦	氣 亥	气 亥
氧	氣 羊	气 羊
氨	氣 安	气 安
氪	氣 克	气 克
氫	氣 巠	气 巠
氬	氣 亞	气 亞
氭	氣 東	气 東
氮	氣 炎	气 炎
氯	氣 彔	气 彔
氰	氣 青	气 青
氱	氣 昜	气 昜
氳	氣 昷	气 昷
汙	水 于	氵 于
汚	水 亐	氵 亐
汭	水 內	氵 內
決	水 夬	氵 夬
沒	水 勹 又	氵 勹 又
沖	水 中	氵 中
沢	水 尺	氵 尺
況	水 兄	氵 兄
洶	水 匈	氵 匈
浄	水 争	氵 争
浹	水 夾	氵 夾
浿	水 貝	氵 貝
涀	水 見	氵 見
涇	水 巠	氵 巠
涗	水 兌	氵 兌
涜	水 売	氵 売
涱	水 長	氵 長
涷	水 東	氵 東
涼	水 京	氵 京
淒	水 妻	氵 妻
淙	水 宗	氵 宗
淚	水 戾	氵 戾
淥	水 彔	氵 彔
淨	水 爭	氵 爭
淪	水 侖	氵 侖
淭	水 戶 木	氵 戶 木
淵	水 片 一 爿	氵 片 一 爿
淶	水 來	氵 來
淸	水 靑	氵 靑
淺	水 戔	氵 戔
済	水 斉	氵 斉
渉	水 歩	氵 歩
渙	水 奐	氵 奐
減	水 咸	氵 咸
渢	水 風	氵 風
渦	水 咼	氵 咼
測	水 則	氵 則
渾	水 軍	氵 軍
湊	水 奏	氵 奏
湋	水 韋	氵 韋
湏	水 頁	氵 頁
湞	水 貞	氵 貞
湧	水 勇	氵 勇
湯	水 昜	氵 昜
満	水 草 両	氵 艸 両	氵 艹 両
溈	水 為	氵 為
溌	水 発	氵 発
溍	水 晉	氵 晉
溑	水 小 貝	氵 小 貝
準	水 隹 十	氵 隹 十
溝	水 冓	氵 冓
溡	水 時	氵 時
溣	水 侖	氵 侖
溤	水 馬	氵 馬
溩	水 烏	氵 烏
溫	水 昷	氵 昷
溮	水 師	氵 師
溰	水 豈	氵 豈
溳	水 員	氵 員
溼	水 一 幺 幺 土	氵 一 幺 幺 土
滄	水 倉	氵 倉
滅	水 戊 一 火	氵 戊 一 火	水 烕	氵 烕
滊	水 氣	氵 氣
滌	水 條	氵 條
滎	火 火 冖 水	𤇾 水
滙	水 匚 隹	氵 匚 隹
滝	水 竜	氵 竜
滬	水 戶 邑	氵 戶 邑
滭	水 畢	氵 畢
滯	水 帶	氵 帶
滲	水 參	氵 參
滷	水 鹵	氵 鹵
滸	水 許	氵 許
滻	水 產	氵 產
滾	水 袞	氵 袞
滿	水 廿 冂 丨 入 入	氵 廿 冂 丨 入 入	水 㒼	氵 㒼
漁	水 魚	氵 魚
漊	水 婁	氵 婁
漍	水 國	氵 國
漐	執 水
漑	水 旣	氵 旣
漒	水 強	氵 強
漙	水 專	氵 專
漚	水 區	氵 區
漞	水 覓	氵 覓
漡	水 丿 一 昜	氵 丿 一 昜
漢	水 革 大	氵 革 大
漣	水 連	氵 連
漬	水 責	氵 責
漲	水 張	氵 張
漸	水 斬	氵 斬
漿	水 將
潁	匕 水 頁
潅	水 丿 二 隹	氵 丿 二 隹
潑	水 發	氵 發
潔	水 絜	氵 絜
潕	水 無	氵 無
潙	水 爲	氵 爲
潚	水 肅	氵 肅
潛	水 朁	氵 朁
潢	水 黃	氵 黃
潣	水 閔	氵 閔
潤	水 閏	氵 閏
潬	水 單	氵 單
潯	水 尋	氵 尋
潰	水 貴	氵 貴
潷	水 筆	氵 筆
潿	水 圍	氵 圍
澀	水 歰	氵 歰
澃	須 水
澅	水 畫	氵 畫
澆	水 堯	氵 堯
澇	水 勞	氵 勞
澐	水 雲	氵 雲
澒	水 項	氵 項
澕	水 華	氵 華
澖	水 閑	氵 閑
澗	水 間	氵 間
澟	水 稟	氵 稟
澠	水 黽	氵 黽
澢	水 當	氵 當
澤	水 睪	氵 睪
澦	水 預	氵 預
澩	臼 爻 冖 水	𦥯 水
澫	水 萬	氵 萬
澬	水 資	氵 資
澮	水 會	氵 會
澰	水 僉	氵 僉
澱	水 殿	氵 殿
澲	水 業	氵 業
澳	水 奧	氵 奧
澾	水 達	氵 達
濁	水 蜀	氵 蜀
濃	水 農 膿	氵 農 膿
濄	水 過	氵 過
濆	水 賁	氵 賁
濇	水 嗇	氵 嗇
濊	水 歲	氵 歲
濔	水 爾	氵 爾
濕	水 日 幺 幺 火	氵 日 幺 幺 灬	水 㬎	氵 㬎
濘	水 寧	氵 寧
濙	水 熒	氵 熒
濚	水 榮	氵 榮
濛	水 蒙	氵 蒙
濜	水 盡	氵 盡
濟	水 齊	氵 齊
濤	水 壽	氵 壽
濦	水 爪 工 彐 心	氵 爫 工 彐 心	水 㥯	氵 㥯
濧	水 對	氵 對
濫	水 監	氵 監
濮	水 僕	氵 僕
濰	水 維	氵 維
濱	水 賓	氵 賓
濳	水 先 先 曰	氵 先 先 曰	水 先 先 日	氵 先 先 日
濴	水 滎	氵 滎
濶	水 門 舌	氵 門 舌
濷	水 滿
濺	水 賤	氵 賤
濻	水 隤	氵 隤
濼	水 樂	氵 樂
濽	水 賛	氵 賛
濾	水 慮	氵 慮
濿	水 厲	氵 厲
瀀	水 憂	氵 憂
瀂	水 魯	氵 魯
瀃	水 賜	氵 賜
瀄	水 節	氵 節
瀅	水 瑩	氵 瑩
瀆	水 賣	氵 賣
瀇	水 廣	氵 廣
瀈	水 翬	氵 翬
瀉	水 寫	氵 寫
瀊	水 盤	氵 盤
瀋	水 審	氵 審
瀋	水 審	氵 審
瀏	水 卯 金 刀	氵 卯 金 刂
瀒	水 來 一 回	氵 來 一 回
瀕	水 頻	氵 頻
瀗	水 憲	氵 憲
瀘	水 盧	氵 盧
瀙	水 親	氵 親
瀝	水 歷	氵 歷
瀟	水 蕭	氵 蕭
瀠	水 縈	氵 縈
瀡	水 隨	氵 隨
瀢	水 遺	氵 遺
瀦	水 豬	氵 豬
瀧	水 龍	氵 龍
瀨	水 賴	氵 賴
瀩	水 頹	氵 頹
瀬	水 頼	氵 頼
瀯	水 營	氵 營
瀰	水 彌	氵 彌
瀲	水 斂	氵 斂
瀴	水 嬰	氵 嬰
瀶	水 臨	氵 臨
瀾	水 闌	氵 闌
灁	水 門 泉	氵 門 泉
灄	水 聶	氵 聶
灆	水 藍	氵 藍
灇	水 叢	氵 叢
灍	水 闕	氵 闕
灎	水 豊 盍	氵 豊 盍
灑	水 麗	氵 麗
灒	水 贊	氵 贊
灓	絲 言 水	糸 言 糸 水	䜌 水
灔	水 艶	氵 艶
灕	水 離	氵 離
灘	水 難	氵 難
灙	水 黨	氵 黨
灚	水 覺	氵 覺
灛	水 闡	氵 闡
灝	水 顥	氵 顥
灟	水 屬	氵 屬
灠	水 覽	氵 覽
灡	水 蘭	氵 蘭
灣	水 彎	氵 水 彎
灤	水 欒	氵 欒
灦	水 顯	氵 顯
灧	水 艷	氵 艷
灪	水 鬱	氵 鬱
災	巛 火
為	丶 丿 ㇆ ㇆ ㇆ 火	丶 丿 ㇆ ㇆ ㇆ 灬
烏	户 一 ㇆ 火	户 一 ㇆ 灬
烴	火 巠
焋	壯 火	壯 灬
焔	火 刀 旧
焛	門 火
無	丿 一 卌 一 火	丿 一 卌 一 灬	丿 一 一 丨 丨 丨 丨 一 火
焭	火 火 冖 几	𤇾 几
焼	火 尭
煇	火 軍
煈	火 風
煉	火 柬
煒	火 韋
煙	火 垔
煢	火 火 冖 卂	𤇾 卂
煥	火 奐
煩	火 頁
煬	火 昜
煱	火 咼
熂	火 氣
熃	務 火
熅	火 昷
熉	火 員
熌	火 閃
熒	火 火 冖 火	𤇾 火
熗	火 倉
熚	火 畢
熡	火 婁
熧	從 火
熰	火 區
熱	埶 灬	執 火
熲	匕 火 頁
熽	火 肅
熾	火 戠
熿	火 黃
燀	火 單
燁	火 華
燆	火 喬
燈	火 登
燉	火 敦
燌	火 賁
燒	火 堯
燖	火 尋
燗	火 閒
燘	火 閔
燙	湯 火
燜	火 悶
營	火 火 冖 呂	𤇾 呂
燠	火 奧
燡	火 睪
燢	臼 爻 冖 火	𦥯 火
燣	火 稟
燤	火 萬
燦	火 粲
燨	火 義
燬	火 毀
燭	火 蜀
燰	火 愛
燲	火 劦 貝
燴	火 會
燶	火 農
燼	火 盡
燾	壽 火	壽 灬
爁	火 監
爃	火 榮
爄	火 厲
爇	蓺 火	蓺 灬	草 熱	艸 熱	艹 熱
爈	火 慮
爉	火 巤
爌	火 廣
爍	火 樂
爏	火 歷
爐	火 盧
爓	火 閻
爖	火 龍
爛	火 闌
爜	火 叢
爣	火 黨
爤	火 蘭
爥	火 屬
爧	火 靈
爩	火 鬱
爭	爪 聿	爫 肀
爲	爪 ㇆ ㇆ ㇆ 火 丿	爫  ㇆ ㇆ ㇆ 灬 丿
爺	父 耶
爾	一 八 冂 丨 爻 爻
牀	爿 木
牄	爿 倉
牆	爿 嗇
牋	片 戔
牘	片 賣
牼	牛 巠	牜 巠
牽	玄 冖 牛
犅	牛 岡	牜 岡
犔	牛 氣	牜 氣
犖	火 火 冖 牛	𤇾 牛
犙	牛 參	牜 參
犡	牛 厲	牜 厲
犢	牛 賣	牜 賣
犤	牛 罷	牜 罷
犧	牛 羲	牜 羲
狀	爿 犬
狹	犬 夾	犭 夾
狽	犬 貝	犭 貝
猌	來 犬
猍	犬 來	犭 來
猙	犬 爭	犭 爭
猦	犬 風	犭 風
猧	犬 咼	犭 咼
猶	犬 酋	犭 酋
猺	犬 月 缶	犭 月 缶	犬 䍃	犭 䍃
猻	犬 孫	犭 孫
獁	犬 馬	犭 馬
獃	豈 犬
獄	犬 言 犬	犭 訁 犬
獅	犬 師	犭 師
獊	犬 倉	犭 倉
獎	將 犬
獑	犬 斬	犭 斬
獖	犬 賁	犭 賁
獚	犬 黃	犭 黃
獟	犬 堯	犭 堯
獢	犬 喬	犭 喬
獨	犬 蜀	犭 蜀
獩	犬 歲	犭 歲
獪	犬 會	犭 會
獫	犬 僉	犭 僉
獮	犬 爾	犭 爾
獰	犬 寧	犭 寧
獱	犬 賓	犭 賓
獲	犬 蒦	犭 蒦	犬 草 隹 又
獵	犬 巤	犭 巤
獶	犬 憂	犭 憂
獷	犬 廣	犭 廣
獸	嘼 犬
獹	犬 盧	犭 盧
獺	犬 賴	犭 賴
獻	虎 鬲 犬	虍 鬲 犬
獼	犬 彌
玀	犬 羅	犭 羅
玁	犬 嚴	犭 嚴
玂	犬 蕇 斤	犭 蕇 斤	犬 蘄	犭 蘄
珊	玉 冊	王 冊
珼	玉 貝	王 貝
現	玉 見	王 見
琖	玉 戔	王 戔
琜	玉 來	王 來
琧	亞 玉
琺	玉 法	王 法
琿	玉 軍	王 軍
瑋	玉 韋	王 韋
瑍	玉 奐	王 奐
瑒	玉 昜	王 昜
瑣	玉 小 貝	王 小 貝
瑤	玉 䍃	王 月 缶	玉 䍃	王 䍃
瑦	玉 烏	王 烏
瑩	火 火 冖 玉	𤇾 玉
瑪	玉 馬	王 馬
瑯	玉 郎	王 郎
瑲	玉 倉	王 倉
瑻	玉 貫	王 貫
瑼	玉 專	王 專
瑽	玉 從	王 從
璉	玉 連	王 連
璊	玉 廿 冂 丨 入 入	王 廿 冂 丨 入 入	玉 㒼	王 㒼
璑	玉 無	王 無
璕	玉 尋	王 尋
璗	湯 玉
璛	玉 肅	王 肅
璜	玉 黃	王 黃
璝	玉 貴	王 貴
璡	玉 進	王 進
璣	玉 幾	王 幾
璦	玉 愛	王 愛
璫	玉 當	王 當
璭	玉 運	王 運
璯	玉 會	王 會
環	玉 睘	王 睘
璳	玉 朱 貝	王 朱 貝
璵	玉 與	王 與
璶	玉 盡	王 盡
璸	玉 賓	王 賓
璹	玉 壽	王 壽
璺	臼 同 冖 玉
璼	玉 監	王 監
璽	爾 玉
璾	玉 齊	王 齊
瓂	玉 蓋	王 蓋
瓄	玉 賣	王 賣
瓅	玉 樂	王 樂
瓆	玉 質	王 質
瓇	玉 憂	王 憂
瓉	玉 賛	王 賛
瓊	玉 夐	王 夐
瓋	玉 適	王 適
瓍	玉 隨	王 隨
瓎	玉 賴	王 賴
瓏	玉 龍	王 龍
瓐	玉 盧	王 盧
瓑	玉 歷	王 歷
瓓	玉 闌	王 闌
瓔	玉 嬰	王 嬰
瓕	彌 玉
瓙	玉 壽	王 壽
瓚	玉 贊	王 贊
瓥	瓜 豕 蟲 蟲	瓜 豕 虫 虫
甁	幷 瓦
甆	茲 瓦
甇	火 火 冖 瓦	𤇾 瓦
甊	婁 瓦
甌	區 瓦
甎	專 瓦
甒	無 瓦
甖	賏 瓦	貝 貝 瓦
產	产 生	文 厂 生
産	产 生	立 丿 生
甯	宀 心 用
畄	小 田
畇	田 勻
畝	亩 久
畢	田 艹 一 十
畫	聿 田 一
異	田 共
畵	聿 田 凵
當	尚 田
畼	田 昜
疇	田 壽
疊	畾 冝
痋	病 蟲	疒 蟲	疒 虫
痙	病 巠	疒 巠
痥	病 兌	疒 兌
痮	病 長	疒 長
痲	病 林	疒 林
瘂	病 亞	疒 亞
瘋	病 風	疒 風
瘍	病 昜	疒 昜
瘑	病 咼	疒 咼
瘒	病 軍	疒 軍
瘓	病 奐	疒 奐
瘡	病 倉	疒 倉
瘧	病 虐	疒 虐
瘬	病 張	疒 張
瘮	病 參	疒 參
瘱	病 夾	疒 夾
瘲	病 從	疒 從
瘹	病 釣	疒 釣
瘻	病 婁	疒 婁
癀	病 黃	疒 黃
療	病 尞	疒 尞
癆	病 勞	疒 勞
癇	病 閒	疒 閒
癈	病 發	疒 發
癉	病 單	疒 單
癋	病 惡	疒 惡
癎	病 間	疒 間
癐	病 會	疒 會
癑	病 農	疒 農
癒	病 愈	疒 愈
癘	病 萬	疒 萬
癛	病 稟	疒 稟
癟	病 自 侖	疒 自 侖
癠	病 齊	疒 齊
癡	病 疑	疒 疑
癢	病 養	疒 養
癤	病 節	疒 節
癧	病 歷	疒 歷
癩	病 賴	疒 賴
癬	病 鮮	疒 鮮
癭	病 嬰	疒 嬰
癮	病 隱	疒 隱
癰	病 雝	疒 雝
癱	病 難	疒 難
癲	病 顛	疒 顛
癴	病 攣	疒 攣
癵	病 臠	疒 臠
発	癶 兀 一	癶 二 儿	癶 开
發	癶 弓 殳
皚	白 豈
皟	白 責
皣	白 華
皧	白 愛
皪	白 樂
皸	軍 皮
皹	皮 軍
皺	芻 皮
皾	賣 皮
盃	不 皿
盜	水 欠 皿	氵 欠 皿
盞	戔 皿
盡	聿 火 皿	聿 灬 皿
監	臣 丿 一 丶 皿
盤	般 皿
盧	虎 田 皿	虍 田 皿
盨	須 皿
盪	湯 皿
眾	网 丿 丨 人 人	罒 丿 丨 人 人	罓 丿 丨 人 人
睏	目 困
睔	目 侖
睜	目 爭
睞	目 來
睴	目 軍
瞇	目 迷
瞓	目 訓
瞗	目 鳥
瞘	目 區
瞛	目 從
瞜	目 婁
瞞	目 廿 冂 丨 入 入	目 㒼
瞡	目 規
瞤	目 閏
瞭	目 尞
瞯	目 閒
瞱	目 華
瞴	目 無
瞶	目 貴
瞷	目 間
瞹	目 愛
瞺	目 會
瞼	目 僉
矃	目 寧
矇	目 蒙
矉	目 賓
矊	目 綿
矋	目 厲
矌	目 廣
矑	目 盧
矓	目 龍
矕	絲 言 目	糸 言 糸 目	䜌 目
矖	目 麗
矘	目 黨
矙	目 闞
矚	目 屬
矯	矢 喬
矲	矢 罷
硜	石 巠
硤	石 夾
硨	石 車
硯	石 見
硻	臤 石
碀	石 爭
碁	其 石
碊	石 戔
碌	石 彔
碖	石 侖
碙	石 岡
碢	石 咼
碩	石 頁
碭	石 昜
碯	石 巛 囟	石 𡿺
碸	石 風
確	石 隺
碼	石 馬
碽	石 貢
磑	石 豈
磒	石 員
磚	石 專
磛	斬 石
磠	石 鹵
磣	石 參
磧	石 責
磫	石 從
磯	石 幾
磱	石 勞
磵	石 間
磺	石 黃
磽	石 堯
磾	石 單
礄	石 喬
礆	石 僉
礋	石 睪
礎	石 楚
礏	石 業
礐	臼 爻 冖 石	𦥯 石
礑	石 當
礒	石 義
礖	石 與
礗	石 賓
礘	石 日 幺 幺 火	石 日 幺 幺 灬	石 㬎
礙	石 疑
礚	石 蓋
礛	石 監
礜	與 石
礟	石 駁
礥	石 賢
礦	石 廣
礩	石 質
礪	石 厲
礫	石 樂
礮	石 馬 交
礯	石 縈
礰	石 歷
礱	龍 石
礲	石 龍
礷	石 藍
礸	石 贊
礹	石 嚴
祱	示 兌	礻 兌
祿	示 彔	礻 彔
禈	示 軍	礻 軍
禍	示 咼	礻 咼
禎	示 貞	礻 貞
禓	示 昜	礻 昜
禕	示 韋	礻 韋
禜	火 火 冖 示	𤇾 示
禡	示 馬	礻 馬
禦	御 示
禨	示 幾	礻 幾
禪	示 單	礻 單
禬	示 會	礻 會
禮	示 豊	礻 豊
禯	示 農	礻 農
禰	示 爾	礻 爾
禱	示 壽	礻 壽
禲	示 厲	礻 厲
禵	示 題	礻 題
禶	示 贊	礻 贊
禷	示 類	礻 類
禿	禾 儿
稅	禾 兌
稆	禾 呂
稏	禾 亞
稐	禾 侖
稜	禾 夌
稟	亠 回 禾
稦	禾 韋
種	禾 重
稱	禾 爯	禾 爪 冉	禾 爫 冉
稲	禾 爪 旧	禾 爫 旧
穀	士 冖 禾 殳
穂	禾 恵
穇	禾 參
穌	魚 禾
積	禾 責
穎	匕 禾 頁
穏	禾 爪 彐 心	禾 爫 彐 心
穔	禾 黃
穖	禾 幾
穘	禾 堯
穚	禾 喬
穠	禾 農
穡	禾 嗇
穢	禾 歲
穥	禾 與
穧	禾 齊
穨	禿 貴
穩	禾 爪 工 彐 心	禾 爫 工 彐 心	禾 㥯
穪	禾 爾
穫	禾 蒦	禾 草 隹 又
穬	禾 廣
穭	禾 魯
穲	禾 麗
穳	禾 贊
窩	穴 咼
窪	穴 洼	穴 水 圭	穴 氵 圭
窮	穴 躬
窯	穴 羔
窰	穴 月 缶	穴 䍃
窵	穴 鳥
窶	穴 婁
窺	穴 規
竀	穴 正 見
竄	穴 鼠
竅	穴 敫
竇	穴 賣
竈	穴 土 黽
竉	穴 龍
竊	穴 釆 禼	穴 采 禼
竜	立 电
竪	臣 又 立
竫	立 爭
竱	立 專
競	竞 竞	立 兄 立 兄
笉	竹 勻
笍	竹 內
筆	竹 聿
筍	竹 旬
筧	竹 見
筫	竹 貝
筴	竹 夾
箂	竹 來
箆	竹 內 比
箋	竹 戔
箏	竹 爭
箹	竹 約
節	竹 艮 卩
範	竹 車 卩	竹 車 㔾
築	筑 木	竹 巩 木	竹 工 凡 木
篋	竹 匧
篔	竹 員
篠	竹 條
篢	竹 貢
篤	竹 馬
篩	竹 師
篬	竹 倉
篭	竹 竜
篳	竹 畢
篵	竹 從
篸	竹 參
篿	竹 專
簀	竹 責
簂	竹 國
簍	竹 婁
簐	竹 軟
簘	竹 粛
簜	竹 湯
簞	竹 單
簡	竹 間
簢	竹 閔
簣	竹 貴
簤	竹 買
簥	竹 喬
簧	竹 黃
簩	竹 勞
簪	竹 旡 旡 日	竹 朁
簫	竹 肅
簵	竹 輅
簷	竹 詹
簹	竹 當
簻	竹 過
簽	竹 僉
簾	竹 廉
籃	竹 監
籄	竹 貴
籉	竹 臺
籋	竹 爾
籌	竹 壽
籔	竹 數
籙	竹 錄
籚	竹 盧
籛	竹 戔
籜	竹 擇
籟	竹 賴
籠	竹 龍
籢	竹 斂
籣	竹 闌
籤	竹 韱	竹 人 人 戈 韭
籨	竹 歛
籩	竹 邊
籪	竹 斷
籫	竹 贊
籬	竹 離
籭	竹 麗
籮	竹 羅
籲	籥 頁	竹 龠 頁
粛	聿 丿 米 丨	肀 丿 米 丨
粣	米 冊
粯	米 見
粵	丶 冂 采 亏	丶 冂 釆 亏
粻	米 長
糃	米 昜
糉	米 凶 八 夕	米 凶 八 夂
糍	米 茲
糚	米 莊
糝	米 參
糞	米 異	米 田 共
糧	米 量
糩	米 會
糮	米 堅
糰	米 團
糲	米 厲
糴	籴 翟
糷	米 蘭
糺	絲 乚	糹 乚	糸 乚
糼	絲 力	糹 力	糸 力
糽	絲 丁	糹 丁	糸 丁
糾	絲 丩	糹 丩	糸 丩
糿	絲 刀	糹 刀	糸 刀
紀	絲 己	糹 己	糸 己
紁	絲 义	糹 义	糸 义
紂	絲 寸	糹 寸	糸 寸
紃	絲 川	糹 川	糸 川
約	絲 勺	糹 勺	糸 勺
紅	絲 工	糹 工	糸 工
紆	絲 于	糹 于	糸 于
紇	絲 乞	糹 乞	糸 乞
紈	絲 丸	糹 丸	糸 丸
紉	絲 刃	糹 刃	糸 刃
紊	文 絲	文 糸
紋	絲 文	糹 文	糸 文
紌	絲 尤	糹 尤	糸 尤
納	絲 內	糹 內	糸 內
紎	絲 犬	糹 犬	糸 犬
紏	絲 斗	糹 斗	糸 斗
紐	絲 丑	糹 丑	糸 丑
紑	絲 不	糹 不	糸 不
紒	絲 介	糹 介	糸 介
紓	絲 予	糹 予	糸 予
純	絲 屯	糹 屯	糸 屯
紕	絲 比	糹 比	糸 比
紖	絲 引	糹 引	糸 引
紗	絲 少	糹 少	糸 少
紘	絲 厷	糹 厷	糸 厷
紙	絲 氏	糹 氏	糸 氏
級	絲 及	糹 及	糸 及
紛	絲 分	糹 分	糸 分
紜	絲 云	糹 云	糸 云
紝	絲 壬	糹 壬	糸 壬
紞	絲 冘	糹 冘	糸 冘
紟	絲 今	糹 今	糸 今
素	丰 絲	丰 糸
紡	絲 方	糹 方	糸 方
索	十 冖 絲	十 冖 糸
紣	絲 卆	糹 卆	糸 卆
紤	絲 斤	糹 斤	糸 斤
紨	絲 付	糹 付	糸 付
紩	絲 失	糹 失	糸 失
紪	絲 此	糹 此	糸 此
紫	此 絲	此 糸
紬	絲 由	糹 由	糸 由
紭	絲 弘	糹 弘	糸 弘
紮	札 絲	札 糸
累	田 絲	田 糸
細	絲 田	糹 田	糸 田
紱	絲 犮	糹 犮	糸 犮
紲	絲 世	糹 世	糸 世
紳	絲 申	糹 申	糸 申
紴	絲 皮	糹 皮	糸 皮
紵	絲 宁	糹 宁	糸 宁
紶	絲 去	糹 去	糸 去
紷	絲 令	糹 令	糸 令
紸	絲 主	糹 主	糸 主
紹	絲 召	糹 召	糸 召
紺	絲 甘	糹 甘	糸 甘
紻	絲 央	糹 央	糸 央
紼	絲 弗	糹 弗	糸 弗
紽	絲 它	糹 它	糸 它
紾	絲 人 彡	糹 人 彡	糸 人 彡
紿	絲 台	糹 台	糸 台
絀	絲 出	糹 出	糸 出
絁	絲 丿 一 也	糹 丿 一 也	糸 丿 一 也
終	絲 冬	糹 冬	糸 冬
絃	絲 玄	糹 玄	糸 玄
組	絲 且	糹 且	糸 且
絅	絲 冋	糹 冋	糸 冋
絆	絲 半	糹 半	糸 半
絇	絲 句	糹 句	糸 句
絈	絲 白	糹 白	糸 白
絉	絲 术	糹 术	糸 术
絊	絲 本	糹 本	糸 本
経	絲 圣	糹 圣	糸 圣
絍	絲 任	糹 任	糸 任
絎	絲 行	糹 行	糸 行
絏	絲 曳	糹 曳	糸 曳
結	絲 吉	糹 吉	糸 吉
絑	絲 朱	糹 朱	糸 朱
絒	絲 州	糹 州	糸 州
絓	絲 圭	糹 圭	糸 圭
絔	絲 百	糹 百	糸 百
絕	絲 刀 巴	糹 刀 巴	糸 刀 巴	絲 色	糹 色	糸 色
絖	絲 光	糹 光	糸 光
絗	絲 回	糹 回	糸 回
絘	絲 次	糹 次	糸 次
絙	絲 亘	糹 亘	糸 亘
絚	絲 亙	糹 亙	糸 亙
絝	絲 夸	糹 夸	糸 夸
絞	絲 交	糹 交	糸 交
絟	絲 全	糹 全	糸 全
絠	絲 有	糹 有	糸 有
絡	絲 各	糹 各	糸 各
絢	絲 旬	糹 旬	糸 旬
絣	絲 并	糹 并	糸 并	絲 幷	糹 幷	糸 幷
絤	絲 西	糹 西	糸 西
絥	絲 伏	糹 伏	糸 伏
給	絲 合	糹 合	糸 合
絧	絲 同	糹 同	糸 同
絨	絲 戎	糹 戎	糸 戎
絩	絲 兆	糹 兆	糸 兆
絪	絲 因	糹 因	糸 因
絬	絲 舌	糹 舌	糸 舌
絮	如 絲	如 糸
絯	絲 亥	糹 亥	糸 亥
絰	絲 至	糹 至	糸 至
統	絲 充	糹 充	糸 充
絲	絲 絲	糹 糹	糸 糸
絳	絲 夅	糹 夅	糸 夅
絴	絲 羊	糹 羊	糸 羊
絵	絲 会	糹 会	糸 会
絶	絲 色	糹 色	糸 色
絸	絲 見	糹 見	糸 見
絹	絲 肙	糹 肙	糸 肙
絺	絲 希	糹 希	糸 希
絻	絲 免	糹 免	糸 免
絼	絲 豸	糹 豸	糸 豸
絽	絲 呂	糹 呂	糸 呂
絾	絲 成	糹 成	糸 成
絿	絲 求	糹 求	糸 求
綀	絲 束	糹 束	糸 束
綁	絲 邦	糹 邦	糸 邦
綂	絲 亠 兄	糹 亠 兄	糸 亠 兄
綃	絲 肖	糹 肖	糸 肖
綄	絲 完	糹 完	糸 完
綅	絲 彐 冖 又	糹 彐 冖 又	糸 彐 冖 又
綆	絲 更	糹 更	糸 更
綇	絲 酉	糹 酉	糸 酉
綈	絲 弟	糹 弟	糸 弟
綉	絲 秀	糹 秀	糸 秀
綊	絲 夾	糹 夾	糸 夾
綋	絲 宏	糹 宏	糸 宏
綌	絲 谷	糹 谷	糸 谷
綍	絲 孛	糹 孛	糸 孛
綎	絲 廷	糹 廷	糸 廷
綏	絲 妥	糹 妥	糸 妥
綐	絲 兌	糹 兌	糸 兌
綑	絲 困	糹 困	糸 困
綒	絲 孚	糹 孚	糸 孚
經	絲 巠	糹 巠	糸 巠
綕	絲 志	糹 志	糸 志
綖	絲 延	糹 延	糸 延
綗	絲 冏	糹 冏	糸 冏
綘	絲 夆	糹 夆	糸 夆
綜	絲 宗	糹 宗	糸 宗
綝	絲 林	糹 林	糸 林
綞	絲 垂	糹 垂	糸 垂
綟	絲 戻	糹 戻	糸 戻
綠	絲 彔	糹 彔	糸 彔
綡	絲 京	糹 京	糸 京
綢	絲 周	糹 周	糸 周
綣	絲 卷	糹 卷	糸 卷
綥	絲 畀	糹 畀	糸 畀
綧	絲 享	糹 享	糸 享
綨	絲 其	糹 其	糸 其
綩	絲 宛	糹 宛	糸 宛
綪	絲 青	糹 青	糸 青
綫	絲 戔	糹 戔	糸 戔
綬	絲 受	糹 受	糸 受
維	絲 隹	糹 隹	糸 隹
綯	絲 匋	糹 匋	糸 匋
綰	絲 官	糹 官	糸 官
綱	絲 岡	糹 岡	糸 岡
網	絲 罔	糹 罔	糸 罔
綳	絲 朋	糹 朋	糸 朋
綴	絲 叕	糹 叕	糸 叕
綵	絲 采	糹 采	糸 采
綶	絲 果	糹 果	糸 果
綷	絲 卒	糹 卒	糸 卒
綸	絲 侖	糹 侖	糸 侖
綹	絲 咎	糹 咎	糸 咎
綺	絲 奇	糹 奇	糸 奇
綻	絲 定	糹 定	糸 定
綼	絲 卑	糹 卑	糸 卑
綽	絲 卓	糹 卓	糸 卓
綾	絲 夌	糹 夌	糸 夌
綿	絲 帛	糹 帛	糸 帛
緀	絲 妻	糹 妻	糸 妻
緁	絲 疌	糹 疌	糸 疌
緂	絲 炎	糹 炎	糸 炎
緃	絲 從	糹 從	糸 從
緄	絲 昆	糹 昆	糸 昆
緅	絲 取	糹 取	糸 取
緆	絲 易	糹 易	糸 易
緇	絲 甾	糹 甾	糸 甾
緈	絲 幸	糹 幸	糸 幸
緉	絲 兩	糹 兩	糸 兩
緊	臤 絲	臤 糸
緋	絲 非	糹 非	糸 非
緌	絲 委	糹 委	糸 委
緍	絲 昏	糹 昏	糸 昏
緎	絲 或	糹 或	糸 或
総	絲 忩	糹 忩	糸 忩
緑	絲 录	糹 录	糸 录
緒	絲 者	糹 者	糸 者
緓	絲 英	糹 英	糸 英
緔	絲 尚	糹 尚	糸 尚
緖	絲 者 丶	糹 者 丶	糸 者 丶
緗	絲 相	糹 相	糸 相
緘	絲 咸	糹 咸	糸 咸
緙	絲 革	糹 革	糸 革
線	絲 泉	糹 泉	糸 泉
線	絲 泉	糹 泉	糸 泉
緛	絲 耎	糹 耎	糸 耎
緝	絲 咠	糹 咠	糸 咠
緞	絲 段	糹 段	糸 段
緟	絲 重	糹 重	糸 重
締	絲 帝	糹 帝	糸 帝
緡	絲 昬	糹 昬	糸 昬
緢	絲 苗	糹 苗	糸 苗
緣	絲 彖	糹 彖	糸 彖
緤	絲 枼	糹 枼	糸 枼
緥	絲 保	糹 保	糸 保
緦	絲 思	糹 思	糸 思
緧	絲 酋	糹 酋	糸 酋
編	絲 扁	糹 扁	糸 扁
緩	絲 爰	糹 爰	糸 爰
緪	絲 恆	糹 恆	糸 恆
緫	絲 怱	糹 怱	糸 怱
緬	絲 面	糹 面	糸 面
緭	絲 胃	糹 胃	糸 胃
緮	絲 复	糹 复	糸 复
緯	絲 韋	糹 韋	糸 韋
緰	絲 俞	糹 俞	糸 俞
緱	絲 侯	糹 侯	糸 侯
緲	絲 目 少	糹 目 少	糸 目 少
練	絲 柬	糹 柬	糸 柬
緵	絲 凶 八 夕	糹 凶 八 夕	糸 凶 八 夕	絲 凶 八 夂	糹 凶 八 夂	糸 凶 八 夂
緶	絲 便	糹 便	糸 便
緷	絲 軍	糹 軍	糸 軍
緸	絲 垔	糹 垔	糸 垔
緹	絲 是	糹 是	糸 是
緺	絲 咼	糹 咼	糸 咼
緻	絲 致	糹 致	糸 致
緼	絲 昷	糹 昷	糸 昷
緽	絲 貞	糹 貞	糸 貞
緾	絲 厘	糹 厘	糸 厘
緿	絲 怠	糹 怠	糸 怠
縀	絲 叚	糹 叚	糸 叚
縁	絲 緣	糹 緣	糸 緣
縂	絲 总	糹 总	糸 总
縃	絲 胥	糹 胥	糸 胥
縆	絲 恒	糹 恒	糸 恒
縈	火 火 冖 絲	火 火 冖 糸	𤇾 絲	𤇾 糸
縉	絲 晉	糹 晉	糸 晉
縊	絲 益	糹 益	糸 益
縋	絲 追	糹 追	糸 追
縌	絲 逆	糹 逆	糸 逆
縍	絲 旁	糹 旁	糸 旁
縎	絲 骨	糹 骨	糸 骨
縐	絲 芻	糹 芻	糸 芻
縑	絲 兼	糹 兼	糸 兼
縒	絲 差	糹 差	糸 差
縓	絲 原	糹 原	糸 原
縔	絲 桑	糹 桑	糸 桑
縕	絲 昷	糹 昷	糸 昷
縖	絲 害	糹 害	糸 害
縗	絲 衰	糹 衰	糸 衰
縘	絲 奚	糹 奚	糸 奚
縙	絲 茸	糹 茸	糸 茸
縚	絲 舀	糹 舀	糸 舀
縛	絲 尃	糹 尃	糸 尃
縜	絲 員	糹 員	糸 員
縝	絲 真	糹 真	糸 真
縞	絲 高	糹 高	糸 高
縟	絲 辱	糹 辱	糸 辱
縡	絲 宰	糹 宰	糸 宰
縣	県 系
縤	絲 素	糹 素	糸 素
縥	絲 秦	糹 秦	糸 秦
縦	絲 従	糹 従	糸 従
縧	絲 條	糹 條	糸 條
縩	絲 祭	糹 祭	糸 祭
縪	絲 畢	糹 畢	糸 畢
縫	絲 逢	糹 逢	糸 逢
縬	絲 戚	糹 戚	糸 戚
縭	絲 离	糹 离	糸 离
縮	絲 宿	糹 宿	糸 宿
縯	絲 寅	糹 寅	糸 寅
縰	絲 徙	糹 徙	糸 徙
縱	絲 從	糹 從	糸 從
縲	絲 累	糹 累	糸 累
縳	絲 專	糹 專	糸 專
縴	絲 牽	糹 牽	糸 牽
縵	絲 曼	糹 曼	糸 曼
縶	執 糸
縷	絲 婁	糹 婁	糸 婁
縸	絲 莫	糹 莫	糸 莫
縹	絲 票	糹 票	糸 票
縺	絲 連	糹 連	糸 連
縼	絲 旋	糹 旋	糸 旋
總	絲 悤	糹 悤	糸 悤	糸 囱 心
績	絲 責	糹 責	糸 責
縿	絲 參	糹 參	糸 參
繀	絲 崔	糹 崔	糸 崔
繁	每 攴 絲	每 攵 糸
繂	絲 率	糹 率	糸 率
繃	絲 崩	糹 崩	糸 崩
繅	絲 巢	糹 巢	糸 巢
繆	絲 翏	糹 翏	糸 翏
繈	絲 強	糹 強	糸 強
繉	絲 目 兆	糹 目 兆	糸 目 兆
繍	絲 粛	糹 粛	糸 粛
繎	絲 然	糹 然	糸 然
繏	絲 巽	糹 巽	糸 巽
繐	絲 惠	糹 惠	糸 惠
繑	絲 喬	糹 喬	糸 喬
繒	絲 曾	糹 曾	糸 曾
繓	絲 最	糹 最	糸 最
織	絲 戠	糹 戠	糸 戠
繕	絲 善	糹 善	糸 善
繖	絲 散	糹 散	糸 散
繗	絲 粦	糹 粦	糸 粦
繘	絲 矞	糹 矞	糸 矞
繙	絲 番	糹 番	糸 番
繚	絲 尞	糹 尞	糸 尞
繜	絲 尊	糹 尊	糸 尊
繝	絲 閒	糹 閒	糸 閒
繞	絲 堯	糹 堯	糸 堯
繟	絲 單	糹 單	糸 單
繡	絲 肅	糹 肅	糸 肅
繢	絲 貴	糹 貴	糸 貴
繣	絲 畫	糹 畫	糸 畫
繥	絲 喜	糹 喜	糸 喜
繦	絲 强	糹 强	糸 强
繨	絲 達	糹 達	糸 達
繩	絲 黽	糹 黽	糸 黽
繪	絲 會	糹 會	糸 會
繫	車 凵 殳
繬	絲 嗇	糹 嗇	糸 嗇
繭	草 冂 丨 絲 蟲	草 冂 丨 糸 虫	艹 虫 茧	艸 冂 丨 糸 虫	艹 冂 丨 糸 虫
繮	絲 畺	糹 畺	糸 畺
繯	絲 睘	糹 睘	糸 睘
繰	絲 喿	糹 喿	糸 喿
繱	絲 葱	糹 葱	糸 葱
繲	絲 解	糹 解	糸 解
繳	絲 敫	糹 敫	糸 敫
繵	絲 亶	糹 亶	糸 亶
繶	絲 意	糹 意	糸 意
繷	絲 農	糹 農	糸 農
繸	絲 遂	糹 遂	糸 遂
繹	絲 睪	糹 睪	糸 睪
繺	絲 煞	糹 煞	糸 煞
繻	絲 需	糹 需	糸 需
繼	絲 丨 一 幺 幺 一 幺 幺	糹 丨 一 幺 幺 一 幺 幺	糸 丨 一 幺 幺 一 幺 幺	糸 𠃊 幺 幺 一 幺 幺
繽	絲 賓	糹 賓	糸 賓
繾	絲 遣	糹 遣	糸 遣
繿	絲 監	糹 監	糸 監
纀	絲 僕	糹 僕	糸 僕
纁	絲 熏	糹 熏	糸 熏
纃	絲 齊	糹 齊	糸 齊
纄	絲 蓬	糹 蓬	糸 蓬
纅	絲 樂	糹 樂	糸 樂
纆	絲 墨	糹 墨	糸 墨
纇	米 糸 頁
纈	絲 頡	糹 頡	糸 頡
纉	絲 賛	糹 賛	糸 賛
纊	絲 廣	糹 廣	糸 廣
纋	絲 憂	糹 憂	糸 憂
續	絲 賣	糹 賣	糸 賣
纎	絲 韯	糹 韯	糸 韯
纏	絲 广 里 儿 土	糹 广 里 儿 土	糸 广 里 儿 土
纑	絲 盧	糹 盧	糸 盧
纒	絲 广 黒 土	糹 广 黒 土	糸 广 黒 土
纓	絲 嬰	糹 嬰	糸 嬰
纔	絲 毚	糹 毚	糸 毚
纕	絲 襄	糹 襄	糸 襄
纖	絲 韱	糹 韱	糸 韱
纗	絲 巂	糹 巂	糸 巂
纘	絲 贊	糹 贊	糸 贊
纙	絲 羅	糹 羅	糸 羅
纚	絲 麗	糹 麗	糸 麗
纜	絲 覽	糹 覽	糸 覽
纝	絲 纍	糹 纍	糸 纍
纞	絲 戀	糹 戀	糸 戀
缽	缶 本
罁	缶 岡
罃	火 火 冖 缶	𤇾 缶
罆	缶 貫
罈	缶 覃
罊	車 凵 殳 缶
罌	貝 貝 缶
罎	缶 曇
罏	缶 盧
罰	网 言 刀	罒 訁 刂	罓 訁 刂
罵	网 馬	罒 馬	罓 馬	口 口 馬
罷	网 能	罒 能
罸	网 討	罒 討
罼	网 畢	罒 畢
羂	网 絹	罒 絹
羄	网 綽	罒 綽
羅	网 維	罒 維	罓 維
羆	网 熊	罒 熊	罷 火	罷 灬
羈	网 革 馬	罒 革 馬
羉	目 絲 言	目 糸 言 糸	目 䜌	罒 䜌
羥	羊 巠
羨	羊 水 欠	羊 氵 欠
義	羊 我
羴	羊 羊 羊
羵	羊 賁
羷	羊 僉
羻	羊 慶
習	羽 白
翜	羽 夾
翬	羽 軍
翴	羽 連
翵	羽 鳥
翸	賁 羽
翹	堯 羽
翺	臯 羽
翽	歲 羽
翿	壽 羽
耣	耒 侖
耬	耒 婁
耭	耒 幾
耮	耒 勞
聖	耳 口 王
聗	耳 夾
聞	門 耳
聮	耳 幺 幺 火	耳 幺 幺 灬
聯	耳 幺 幺 丱	耳 幺 幺 卯
聰	耳 悤	耳 囱 心
聲	声 殳 耳	殸 耳
聳	從 耳
聴	耳 十 目 心
聵	耳 貴
聶	耳 耳 耳
職	耳 戠
聹	耳 寧
聻	漸 耳
聼	乛 耳 十 目 一 心
聽	耳 王 十 目 一 心
聾	龍 耳
肁	戶 聿
肅	聿 片 爿	肀 片 一 爿
肈	戶 戈 聿
脅	劦 肉	劦 月
脈	肉 厂 氏	月 厂 氏	肉 𠂢	月 𠂢
脛	肉 巠	月 巠
脥	肉 夾	月 夾
脫	肉 兌	月 兌
脹	肉 長	月 長
脼	肉 兩	月 兩
腀	肉 侖	月 侖
腁	肉 幷	月 幷
腎	臤 肉	臤 月
腖	肉 東	月 東
腡	肉 咼	月 咼
腦	肉 巛 囟	月 巛 囟	肉 𡿺	月 𡿺
腪	肉 軍	月 軍
腫	肉 重	月 重
腳	肉 卻	月 卻
腸	肉 昜	月 昜
膃	肉 昷	月 昷
膋	火 火 冖 肉	火 火 冖 月	𤇾 肉	𤇾 月
膓	肉 丿 一 昜	月 丿 一 昜
膕	肉 國	月 國
膚	虎 胃	虍 胃
膞	肉 專	月 專
膠	肉 翏	月 翏
膢	肉 婁	月 婁
膩	肉 貳	月 貳
膭	肉 貴	月 貴
膮	肉 堯	月 堯
膱	肉 戠	月 戠
膴	肉 無	月 無
膶	肉 閏	月 閏
膷	肉 鄉	月 鄉
膸	肉 遀	月 遀
膹	肉 賁	月 賁
膼	肉 過	月 過
膽	肉 詹	月 詹
膾	肉 會	月 會
膿	肉 農	月 農
臉	肉 僉	月 僉
臍	肉 齊	月 齊
臏	肉 賓	月 賓
臓	肉 蔵	月 蔵
臔	肉 賢	月 賢
臗	肉 寬	月 寬
臘	肉 巤	月 巤
臚	肉 盧	月 盧
臟	肉 藏	月 藏
臠	絲 言 肉	糸 言 糸 肉	䜌 肉
臡	難 肉
臢	肉 贊	月 贊
臥	臣 人
臨	臣 丿 一 品
臺	吉 冖 至
與	臼 一 ㇉ 丶 一 八
興	臼 同 大
舉	與 二 丨	臼 二 丨
舊	草 隹 臼	艸 隹 臼	艹 隹 臼
舖	舍 甫
舗	人 土 口 甫	舍 甫
艙	舟 倉
艛	舟 婁
艜	舟 帶
艡	舟 當
艢	舟 嗇
艣	舟 虜
艤	舟 義
艦	舟 監
艩	舟 齊
艪	舟 魯
艫	舟 盧
艭	舟 雙
艱	革 大 艮
艶	豊 色
艷	豐 色
芻	勹 屮 勹 屮	勹 勹 草 草	勹 勹 艸
苧	草 宁	艸 宁	艹 宁
茣	草 吳	艸 吳	艹 吳
茲	草 幺 幺	艸 幺 幺	艹 幺 幺
荊	草 开 刀	艸 开 刂	艹 开 刂
荘	草 壮	艸 壮	艹 壮
莊	草 壯	艸 壯	艹 壯
莌	草 兌	艸 兌	艹 兌
莒	草 呂	艸 呂	艹 呂
莖	草 巠	艸 巠	艹 巠
莗	草 車	艸 車	艹 車
莢	草 夾	艸 夾	艹 夾
莧	草 見	艸 見	艹 見
菄	草 東	艸 東	艹 東
菓	草 果	艸 果	艹 果
菕	草 侖	艸 侖	艹 侖
菚	草 戔	艸 戔	艹 戔
菛	草 門	艸 門	艹 門
菣	草 臣 又	艸 臣 又	艹 臣 又
華	草 一 草 一 十	艸 一 艹 一 十	艹 一 艹 一 十
菸	草 於	艸 於	艹 於
萇	草 長	艸 長	艹 長
萈	草 見 丶	艸 見 丶	艹 見 丶
萊	草 來	艸 來	艹 來
萕	草 斉	艸 斉	艹 斉
萬	草 禺	艸 禺	艹 禺
萯	草 負	艸 負	艹 負
萴	草 則	艸 則	艹 則
萵	草 咼	艸 咼	艹 咼
葉	草 枼	艸 枼	艹 枼	草 世 木
葒	草 紅	艸 紅	艹 紅
著	草 者	艸 者	艹 者
葝	草 勁	艸 勁	艹 勁
葤	草 紂	艸 紂	艹 紂
葦	草 韋	艸 韋	艹 韋
葯	草 約	艸 約	艹 約
葷	草 軍	艸 軍	艹 軍
葻	草 風	艸 風	艹 風
蒍	草 為	艸 為	艹 為
蒒	草 師	艸 師	艹 師
蒓	草 純	艸 純	艹 純
蒔	草 時	艸 時	艹 時
蒕	草 昷	艸 昷	艹 昷
蒞	草 水 位	艸 氵 位	艹 氵 位
蒳	草 納	艸 納	艹 納
蒶	草 紛	艸 紛	艹 紛
蒷	草 員	艸 員	艹 員
蒼	草 倉	艸 倉	艹 倉
蓀	草 孫	艸 孫	艹 孫
蓋	草 盍	艸 盍	艹 盍	艹 去 皿
蓒	草 軒	艸 軒	艹 軒
蓩	草 務	艸 務	艹 務
蓮	草 連	艸 連	艹 連
蓯	草 從	艸 從	艹 從
蓲	草 區	艸 區	艹 區
蓴	草 專	艸 專	艹 專
蓺	草 埶	艸 埶	艹 埶
蓻	草 執	艸 執	艹 執
蓽	草 畢	艸 畢	艹 畢
蓾	草 鹵	艸 鹵	艹 鹵
蔄	草 問	艸 問	艹 問
蔅	草 門 女	艸 門 女	艹 門 女
蔉	草 袞	艸 袞	艹 袞
蔎	草 設	艸 設	艹 設
蔔	草 匐	艸 匐	艹 匐
蔕	草 帶	艸 帶	艹 帶
蔘	草 參	艸 參	艹 參
蔞	草 婁	艸 婁	艹 婁
蔣	草 將	艸 將	艹 將
蔥	草 悤	艸 悤	艹 悤
蔦	草 鳥	艸 鳥	艹 鳥
蔪	草 斬	艸 斬	艹 斬
蔭	草 陰	艸 陰	艹 陰
蔮	草 國	艸 國	艹 國
蔯	草 陳	艸 陳	艹 陳
蔱	草 殺	艸 殺	艹 殺
蔴	草 麻	艸 麻	艹 麻
蔿	草 爲	艸 爲	艹 爲
蕁	草 尋	艸 尋	艹 尋
蕄	草 悶	艸 悶	艹 悶
蕆	草 戊 貝	艸 戊 貝	艹 戊 貝
蕇	草 單	艸 單	艹 單
蕎	草 喬	艸 喬	艹 喬
蕑	草 閒	艸 閒	艹 閒
蕒	草 買	艸 買	艹 買
蕓	草 雲	艸 雲	艹 雲
蕕	草 猶	艸 猶	艹 猶
蕘	草 堯	艸 堯	艹 堯
蕝	草 絕	艸 絕	艹 絕
蕟	草 發	艸 發	艹 發
蕡	草 賁	艸 賁	艹 賁
蕢	草 貴	艸 貴	艹 貴
蕦	草 須	艸 須	艹 須
蕧	草 復	艸 復	艹 復
蕩	草 湯	艸 湯	艹 湯
蕪	草 無	艸 無	艹 無
蕬	草 絲	艸 絲	艹 絲
蕭	草 肅	艸 肅	艹 肅
蕳	草 間	艸 間	艹 間
蕷	草 預	艸 預	艹 預
蕽	草 農	艸 農	艹 農
薀	草 溫	艸 溫	艹 溫
薁	草 奧	艸 奧	艹 奧
薆	草 愛	艸 愛	艹 愛
薈	草 會	艸 會	艹 會
薊	草 魚 刀	艸 魚 刂	艹 魚 刂
薋	草 資	艸 資	艹 資
薌	草 鄉	艸 鄉	艹 鄉
薍	草 亂	艸 亂	艹 亂
薑	草 畺	艸 畺	艹 畺
薔	草 嗇	艸 嗇	艹 嗇
薖	草 過	艸 過	艹 過
薗	草 園	艸 園	艹 園
薘	草 達	艸 達	艹 達
薚	草 歹 昜	艸 歹 昜	艹 歹 昜
薛	草 戶 乛 一 辛	艸 戶 乛 一 辛	艹 戶 乛 一 辛
薟	草 僉	艸 僉	艹 僉
薠	草 煩	艸 煩	艹 煩
薦	草 廌	艸 廌	艹 廌
薩	草 阜 產	艸 阜 產	艹 阝 產
薫	草 重 火	艸 重 灬	艹 重 灬
薬	草 楽	艸 楽	艹 楽
薱	草 對	艸 對	艹 對
薲	草 賓	艸 賓	艹 賓
薳	草 遠	艸 遠	艹 遠
薴	草 寧	艸 寧	艹 寧
薵	草 壽	艸 壽	艹 壽
薺	草 齊	艸 齊	艹 齊
藀	草 熒	艸 熒	艹 熒
藅	草 罰	艸 罰	艹 罰
藇	草 與	艸 與	艹 與
藉	草 耤	艸 耤	艹 耤
藍	草 監	艸 監	艹 監
藎	草 盡	艸 盡	艹 盡
藖	草 賢	艸 賢	艹 賢
藘	草 慮	艸 慮	艹 慮
藚	草 賣	艸 賣	艹 賣
藛	草 寫	艸 寫	艹 寫
藝	草 埶 云	艸 埶 云	艹 埶 云	草 執 云
藣	草 罷	艸 罷	艹 罷
藥	草 樂	艸 樂	艹 樂
藧	草 緩	艸 緩	艹 緩
藪	草 數	艸 數	艹 數
藬	草 隤	艸 隤	艹 隤
藰	草 劉	艸 劉	艹 劉
藴	草 縕	艸 縕	艹 縕
藶	草 歷	艸 歷	艹 歷
藷	草 諸	艸 諸	艹 諸
藸	草 豬	艸 豬	艹 豬
藹	草 謁	艸 謁	艹 謁
藺	草 閵	艸 閵	艹 閵
藾	草 賴	艸 賴	艹 賴
蘀	草 擇	艸 擇	艹 擇
蘄	草 單 斤	艸 單 斤	艹 單 斤
蘆	草 盧	艸 盧	艹 盧
蘇	草 穌	艸 穌	艹 穌
蘈	草 頹	艸 頹	艹 頹
蘊	草 縕	艸 縕	艹 縕
蘋	草 頻	艸 頻	艹 頻
蘍	草 勳	艸 勳	艹 勳
蘐	草 諼	艸 諼	艹 諼
蘓	草 禾 魚	艸 禾 魚	艹 禾 魚
蘔	草 穎	艸 穎	艹 穎
蘚	草 鮮	艸 鮮	艹 鮮
蘝	草 歛	艸 歛	艹 歛
蘞	草 斂	艸 斂	艹 斂
蘟	草 隱	艸 隱	艹 隱
蘠	草 牆	艸 牆	艹 牆
蘢	草 龍	艸 龍	艹 龍
蘤	草 白 為	艸 白 為	艹 白 為
蘫	草 濫	艸 濫	艹 濫
蘬	草 歸	艸 歸	艹 歸
蘭	草 闌	艸 闌	艹 闌
蘱	草 類	艸 類	艹 類
蘵	草 職	艸 職	艹 職
蘺	草 離	艸 離	艹 離
蘻	草 繫	艸 繫	艹 繫
蘿	草 羅	艸 羅	艹 羅
虃	草 韱	艸 韱	艹 韱
虈	草 吕 頁 吕	艸 吕 頁 吕	艹 吕 頁 吕	艹 口 口 頁 口 口	艹 囂
虉	草 鷊	艸 鷊	艹 鷊
虊	草 欒	艸 欒	艹 欒
處	虎 夕 几	虍 夂 几
虛	虎 丱 一	虍 丱 一
虜	虎 男	虍 男
虞	虎 吳	虍 吳
號	号 虎
虥	虎 戔
虦	戔 虎
虧	虎 隹 亏	虍 隹 亏
虭	蟲 刀	虫 刀
虯	蟲 丩	虫 丩
虰	蟲 丁	虫 丁
虱	乁 一 蟲	乁 一 虫
虳	蟲 勺	虫 勺
虴	蟲 乇	虫 乇
虵	蟲 衆	虫 衆
虶	蟲 于	虫 于
虷	蟲 干	虫 干
虸	蟲 子	虫 子
虹	蟲 工	虫 工
虺	兀 蟲	兀 虫
虻	蟲 亡	虫 亡
虼	蟲 乞	虫 乞
蚄	蟲 方	虫 方
蚅	蟲 厄	虫 厄
蚆	蟲 巴	虫 巴
蚇	蟲 尺	虫 尺
蚈	蟲 开	虫 开
蚉	文 蟲	文 虫
蚊	蟲 文	虫 文
蚋	蟲 內	虫 內
蚌	蟲 丰	虫 丰
蚍	蟲 比	虫 比
蚎	蟲 日	虫 日
蚏	蟲 月	虫 月
蚐	蟲 勻	虫 勻
蚑	蟲 支	虫 支
蚒	蟲 丹	虫 丹
蚓	蟲 引	虫 引
蚔	蟲 氏	虫 氏
蚖	蟲 元	虫 元
蚗	蟲 夬	虫 夬
蚘	蟲 尤	虫 尤
蚙	蟲 今	虫 今
蚚	蟲 斤	虫 斤
蚛	蟲 中	虫 中
蚜	蟲 牙	虫 牙
蚝	蟲 毛	虫 毛
蚞	蟲 木	虫 木
蚟	蟲 王	虫 王
蚠	分 蟲	分 虫
蚡	蟲 分	虫 分
蚢	蟲 亢	虫 亢
蚣	蟲 公	虫 公
蚤	叉 丶 蟲	叉 丶 虫
蚥	蟲 父	虫 父
蚦	蟲 冄	虫 冄
蚧	蟲 介	虫 介
蚨	蟲 夫	虫 夫
蚩	屮 一 蟲	屮 一 虫	山 一 虫
蚪	蟲 斗	虫 斗
蚫	蟲 包	虫 包
蚭	蟲 尼	虫 尼
蚮	蟲 代	虫 代
蚯	蟲 丘	虫 丘
蚰	蟲 由	虫 由
蚱	蟲 乍	虫 乍
蚲	蟲 平	虫 平
蚳	蟲 氐	虫 氐
蚴	蟲 幼	虫 幼
蚵	蟲 可	虫 可
蚶	蟲 甘	虫 甘
蚷	蟲 巨	虫 巨
蚸	蟲 斥	虫 斥
蚹	蟲 付	虫 付
蚺	蟲 冉	虫 冉
蚻	札 蟲	札 虫
蚼	蟲 句	虫 句
蚽	蟲 丕	虫 丕
蚾	蟲 皮	虫 皮
蚿	蟲 玄	虫 玄
蛀	蟲 主	虫 主
蛁	蟲 召	虫 召
蛂	蟲 犮	虫 犮
蛃	蟲 丙	虫 丙
蛄	蟲 古	虫 古
蛅	蟲 占	虫 占
蛆	蟲 且	虫 且
蛇	蟲 它	虫 它
蛈	蟲 失	虫 失
蛉	蟲 令	虫 令
蛋	疋 蟲	疋 虫
蛌	蟲 瓜	虫 瓜
蛍	小 冖 蟲	小 冖 虫
蛐	蟲 曲	虫 曲
蛑	蟲 牟	虫 牟
蛒	蟲 各	虫 各
蛓	十 戈 蟲	土 戈 蟲	十 戈 虫	土 戈 虫	𢦏 蟲	𢦏 虫
蛔	蟲 回	虫 回
蛕	蟲 有	虫 有
蛖	蟲 尨	虫 尨
蛗	戶 乛 一 蟲	戶 乛 一 虫	户 乛 一 蟲	户 乛 一 虫
蛘	蟲 羊	虫 羊
蛙	蟲 圭	虫 圭
蛚	蟲 列	虫 列
蛛	蟲 朱	虫 朱
蛜	蟲 伊	虫 伊
蛝	蟲 艮	虫 艮
蛞	蟲 舌	虫 舌
蛟	蟲 交	虫 交
蛠	蟲 劦	虫 劦
蛡	蟲 羽	虫 羽
蛢	蟲 并	虫 并	蟲 幷	虫 幷
蛣	蟲 吉	虫 吉
蛤	蟲 合	虫 合
蛥	蟲 多	虫 多
蛦	蟲 夷	虫 夷
蛨	蟲 百	虫 百
蛩	巩 蟲	巩 虫
蛪	丰 刀 蟲	丰 刀 虫
蛫	蟲 危	虫 危
蛬	共 蟲	共 虫
蛭	蟲 至	虫 至
蛵	蟲 巠	虫 巠
蛶	蟲 寽	虫 寽
蛷	蟲 求	虫 求
蛸	蟲 肖	虫 肖
蛹	蟲 甬	虫 甬
蛺	蟲 夾	虫 夾
蛻	蟲 兌	虫 兌
蛼	蟲 車	虫 車
蛽	蟲 貝	虫 貝
蛾	蟲 我	虫 我
蛿	蟲 含	虫 含
蜀	网 勹 蟲	罒 勹 蟲	罒 勹 虫
蜁	蟲 丿 一 疋	虫 丿 一 疋
蜂	蟲 夆	虫 夆
蜃	辰 蟲	辰 虫
蜄	蟲 辰	虫 辰
蜅	蟲 甫	虫 甫
蜆	蟲 見	虫 見
蜇	折 蟲	折 虫
蜈	蟲 吳	虫 吳
蜉	蟲 孚	虫 孚
蜊	蟲 利	虫 利
蜋	蟲 良	虫 良
蜌	蟲 比 土	虫 比 土
蜍	蟲 余	虫 余
蜎	蟲 肙	虫 肙
蜏	蟲 秀	虫 秀
蜑	延 蟲	延 虫
蜒	蟲 延	虫 延
蜓	蟲 廷	虫 廷
蜔	蟲 甸	虫 甸
蜖	蟲 囬	虫 囬
蜘	蟲 知	虫 知
蜙	蟲 松	虫 松
蜚	蟲 非	虫 非
蜛	蟲 居	虫 居
蜜	宀 必 蟲	宀 必 虫	宓 蟲	宓 虫
蜝	其 蟲	其 虫
蜞	蟲 其	虫 其
蜟	蟲 育	虫 育
蜠	蟲 囷	虫 囷
蜢	蟲 孟	虫 孟
蜣	蟲 羌	虫 羌
蜤	析 蟲	析 虫
蜥	蟲 析	虫 析
蜦	蟲 侖	虫 侖
蜧	蟲 戾	虫 戾
蜨	蟲 疌	虫 疌
蜩	蟲 周	虫 周
蜪	蟲 匋	虫 匋
蜫	蟲 昆	虫 昆
蜬	蟲 函	虫 函
蜭	蟲 臽	虫 臽
蜮	蟲 或	虫 或
蜯	蟲 奉	虫 奉
蜰	肥 蟲	肥 虫
蜱	蟲 卑	虫 卑
蜲	蟲 委	虫 委
蜳	蟲 享	虫 享
蜴	蟲 易	虫 易
蜵	蟲 片 一 爿	虫 片 一 爿
蜶	蟲 卒	虫 卒
蜷	蟲 卷	虫 卷
蜸	臣 又 蟲	臣 又 虫
蜹	蟲 芮	虫 芮
蜺	蟲 兒	虫 兒
蜻	蟲 青	虫 青
蜼	蟲 隹	虫 隹
蜽	蟲 兩	虫 兩
蜾	蟲 果	虫 果
蜿	蟲 宛	虫 宛
蝀	蟲 東	虫 東
蝁	亞 蟲	亞 虫
蝂	蟲 版	虫 版
蝃	蟲 叕	虫 叕
蝄	蟲 罔	虫 罔
蝅	天 天 蟲	天 天 虫
蝆	蟲 芈	虫 芈
蝋	蟲 鼡	虫 鼡
蝌	蟲 科	虫 科
蝍	蟲 即	虫 即
蝎	蟲 曷	虫 曷
蝏	蟲 亭	虫 亭
蝐	蟲 冒	虫 冒
蝑	蟲 胥	虫 胥
蝒	蟲 面	虫 面
蝓	蟲 俞	虫 俞
蝔	蟲 皆	虫 皆
蝕	食 蟲	飠 虫	食 虫
蝖	蟲 宣	虫 宣
蝗	蟲 皇	虫 皇
蝘	蟲 匽	虫 匽
蝙	蟲 扁	虫 扁
蝚	蟲 柔	虫 柔
蝛	蟲 威	虫 威
蝜	蟲 負	虫 負
蝝	蟲 彖	虫 彖
蝞	蟲 眉	虫 眉
蝟	蟲 胃	虫 胃
蝠	蟲 畐	虫 畐
蝡	蟲 耎	虫 耎
蝢	蟲 頁	虫 頁
蝣	蟲 斿	虫 斿
蝤	蟲 酋	虫 酋
蝥	敄 蟲	敄 虫
蝦	蟲 叚	虫 叚
蝧	蟲 英	虫 英
蝨	卂 蟲 蟲	卂 虫 虫
蝩	蟲 重	虫 重
蝪	蟲 昜	虫 昜
蝫	蟲 者	虫 者
蝬	蟲 凶 八 夕	虫 凶 八 夂
蝭	蟲 是	虫 是
蝮	蟲 复	虫 复
蝯	蟲 爰	虫 爰
蝰	蟲 奎	虫 奎
蝱	亡 蟲 蟲	亡 虫 虫
蝲	蟲 剌	虫 剌
蝳	蟲 毒	虫 毒
蝴	蟲 胡	虫 胡
蝵	秋 蟲	秋 虫
蝶	蟲 枼	虫 枼
蝷	蟲 广 屰	虫 广 屰
蝸	蟲 咼	虫 咼
蝹	蟲 昷	虫 昷
蝺	蟲 禹	虫 禹
蝻	蟲 南	虫 南
蝽	蟲 春	虫 春
蝿	蟲 曰 电	蟲 田 电	虫 曰 电	虫 田 电
螂	蟲 郎	虫 郎
螃	蟲 旁	虫 旁
螄	蟲 師	虫 師
螅	蟲 息	虫 息
螆	蟲 茲	虫 茲
螇	蟲 奚	虫 奚
螈	蟲 原	虫 原
螉	蟲 翁	虫 翁
螊	蟲 兼	虫 兼
螋	蟲 叟	虫 叟
螌	般 蟲	般 虫
融	鬲 蟲	鬲 虫
螎	蟲 鬲	虫 鬲
螏	蟲 疾	虫 疾
螐	蟲 烏	虫 烏
螑	蟲 臭	虫 臭
螒	十 日 十 人 蟲	十 日 十 人 虫
螓	蟲 秦	虫 秦
螔	蟲 虒	虫 虒
螕	蟲 囟 比	虫 囟 比
螖	蟲 骨	虫 骨
螗	蟲 唐	虫 唐
螘	蟲 豈	虫 豈
螙	木 蟲 蟲	木 虫 虫
螚	能 蟲	能 虫
螛	蟲 害	虫 害
螜	士 冖 殳 蟲	士 冖 殳 虫
螝	蟲 鬼	虫 鬼
螞	蟲 馬	虫 馬
螟	蟲 冥	虫 冥
螠	蟲 益	虫 益
螡	文 蟲 蟲	文 虫 虫
螢	火 火 冖 蟲	火 火 冖 虫	𤇾 蟲	𤇾 虫
螣	丷 夫 蟲	丷 夫 虫	𠔉 蟲
螥	蟲 倉	虫 倉
螪	蟲 商	虫 商
螫	赦 蟲	赦 虫
螬	蟲 曹	虫 曹
螭	蟲 离	虫 离
螮	蟲 帶	虫 帶
螯	敖 蟲	敖 虫
螰	蟲 鹿	虫 鹿
螱	尉 蟲	尉 虫
螲	蟲 窒	虫 窒
螳	蟲 堂	虫 堂
螴	陳 蟲	陳 虫
螵	蟲 票	虫 票
螶	巨 蟲 蟲	巨 虫 虫
螷	庳 蟲	庳 虫
螸	欲 蟲	欲 虫
螹	蟲 斬	虫 斬
螺	蟲 累	虫 累
螻	蟲 婁	虫 婁
螼	蟲 堇	虫 堇
螽	冬 蟲 蟲	冬 虫 虫
螾	蟲 寅	虫 寅
螿	將 蟲	將 虫
蟀	蟲 率	虫 率
蟁	民 蟲 蟲	民 虫 虫
蟂	蟲 梟	虫 梟
蟃	蟲 曼	虫 曼
蟄	執 蟲	執 虫
蟅	蟲 庶	虫 庶
蟆	蟲 莫	虫 莫
蟇	莫 蟲	莫 虫
蟈	蟲 國	虫 國
蟉	蟲 翏	虫 翏
蟊	矛 蟲 蟲	矛 虫 虫
蟋	蟲 悉	虫 悉
蟌	蟲 悤	虫 悤
蟍	蟲 梨	虫 梨
蟎	蟲 廿 冂 丨 入 入	虫 廿 冂 丨 入 入	蟲 㒼	虫 㒼
蟑	蟲 章	虫 章
蟒	蟲 莽	虫 莽
蟓	蟲 象	虫 象
蟔	蟲 黑	虫 黑
蟕	蟲 觜	虫 觜
蟖	蟲 斯	虫 斯
蟗	一 口 丨 冂 出 蟲	一 口 丨 冂 出 虫
蟘	蟲 貸	虫 貸
蟙	蟲 戠	虫 戠
蟚	彭 蟲	彭 虫
蟛	蟲 彭	虫 彭
蟜	蟲 喬	虫 喬
蟝	蟲 渠	虫 渠
蟞	敝 蟲	敝 虫
蟟	蟲 尞	虫 尞
蟠	蟲 番	虫 番
蟡	蟲 為	虫 為
蟢	蟲 喜	虫 喜
蟣	蟲 幾	虫 幾
蟤	蟲 巽	虫 巽
蟥	蟲 黃	虫 黃
蟦	蟲 賁	虫 賁
蟧	蟲 勞	虫 勞
蟨	厥 蟲	厥 虫
蟩	蟲 厥	虫 厥
蟪	蟲 惠	虫 惠
蟫	蟲 覃	虫 覃
蟬	蟲 單	虫 單
蟭	蟲 焦	虫 焦
蟮	蟲 善	虫 善
蟯	蟲 堯	虫 堯
蟰	蟲 肅	虫 肅
蟱	蟲 無	虫 無
蟲	虫 虫 虫
蟳	蟲 尋	虫 尋
蟴	斯 蟲	斯 虫
蟶	蟲 聖	虫 聖
蟷	蟲 當	虫 當
蟸	豕 蟲 蟲	豕 虫 虫
蟹	解 蟲	解 虫
蟺	蟲 亶	虫 亶
蟻	虫 義	蟲 義
蟼	敬 蟲	敬 虫
蟽	蟲 達	虫 達
蟾	蟲 詹	虫 詹
蟿	車 凵 殳 蟲	車 凵 殳 虫
蠀	蟲 資	虫 資
蠁	鄉 蟲	鄉 虫
蠂	蟲 葉	虫 葉
蠃	亡 口 月 蟲 凡	亡 口 月 虫 凡
蠄	蟲 禽	虫 禽
蠅	蟲 黽	虫 黽
蠆	萬 蟲	萬 虫
蠇	蟲 萬	虫 萬
蠈	賊 蟲	賊 虫
蠉	蟲 睘	虫 睘
蠊	蟲 廉	虫 廉
蠋	蟲 蜀	虫 蜀
蠌	蟲 睪	虫 睪
蠍	蟲 歇	虫 歇
蠎	蟲 莾	虫 莾
蠏	蟲 解	虫 解
蠐	蟲 齊	虫 齊
蠑	蟲 榮	虫 榮
蠒	爾 蟲	爾 虫
蠓	蟲 蒙	虫 蒙
蠔	蟲 豪	虫 豪
蠕	蟲 需	虫 需
蠖	蟲 蒦	虫 蒦
蠗	蟲 翟	虫 翟
蠘	蟲 截	虫 截
蠙	蟲 賓	虫 賓
蠚	若 蟲 蟲	若 虫 虫
蠛	蟲 蔑	虫 蔑
蠜	棥 大 蟲	棥 大 虫	木 爻 木 大 蟲	木 爻 木 大 虫
蠝	蟲 畾	虫 畾
蠟	蟲 巤	虫 巤
蠠	面 蟲 蟲	面 虫 虫
蠡	彖 蟲 蟲	彖 虫 虫
蠢	春 蟲 蟲	春 虫 虫
蠣	蟲 厲	虫 厲
蠤	酋 蟲 蟲	酋 虫 虫
蠥	辥 蟲	辥 虫
蠦	蟲 盧	虫 盧
蠧	士 冖 石 蟲 蟲	士 冖 石 虫 虫
蠨	蟲 蕭	虫 蕭
蠩	蟲 諸	虫 諸
蠪	龍 蟲	龍 虫
蠫	豸 刀 蟲 蟲	豸 刂 虫 虫
蠬	蟲 龍	虫 龍
蠭	逢 蟲 蟲	逢 虫 虫
蠮	蟲 翳	虫 翳
蠯	广 卑 蟲 蟲	广 卑 虫 虫
蠰	蟲 襄	虫 襄
蠱	蟲 皿	虫 皿
蠳	蟲 嬰	虫 嬰
蠵	蟲 巂	虫 巂
蠶	旡 旡 日 蟲 蟲	旡 旡 日 虫 虫	朁 蟲 蟲	朁 虫 虫
蠷	蟲 瞿	虫 瞿
蠸	蟲 雚	虫 雚
蠹	一 中 冖 石 蟲 蟲	一 中 冖 石 虫 虫
蠺	天 天 日 蟲 蟲	天 天 日 虫 虫
蠻	絲 言 蟲	糸 言 糸 蟲	絲 言 虫	䜌 蟲	䜌 虫
蠼	蟲 瞿 又	虫 瞿 又
蠽	雀 戈 蟲 蟲	雀 戈 虫 虫
蠾	蟲 屬	虫 屬
蠿	幺 幺 一 丨 一 幺 幺 蟲 蟲	幺 幺 一 丨 一 幺 幺 虫 虫
衆	血 乑
衊	血 蔑
術	行 木 丶
衕	行 同
衚	行 胡
衛	行 韋
衝	行 重
衞	行 ㇆ 丨 一 口 币	行 ㇆ 丨 一 口 帀
衲	衣 內	衤 內
袞	衣 八 口
裊	户 一 一 ㇆ 衣
裌	衣 夾	衤 夾
裏	衣 里
補	衣 甫	衤 甫
裝	壯 衣
裞	衣 兌	衤 兌
裡	衣 里	衤 里
裫	衣 片 一 爿	衤 片 一 爿
裲	衣 兩	衤 兩
製	制 衣
複	衣 复	衤 复
褌	衣 軍	衤 軍
褘	衣 韋	衤 韋
褭	衣 馬
褮	火 火 冖 衣	𤇾 衣
褲	衣 庫	衤 庫
褳	衣 連	衤 連
褸	衣 婁	衤 婁
褹	衣 埶	衤 埶
褺	執 衣
褻	衣 埶	衣 執
襀	衣 責	衤 責
襁	衣 強	衤 強
襂	衣 參	衤 參
襇	衣 間	衤 間
襉	衣 閒	衤 閒
襌	衣 單	衤 單
襏	衣 發	衤 發
襑	衣 尋	衤 尋
襓	衣 堯	衤 堯
襔	衣 廿 冂 丨 入 入	衤 廿 冂 丨 入 入	衣 㒼	衤 㒼
襖	衣 奧	衤 奧
襗	衣 睪	衤 睪
襘	衣 會	衤 會
襛	衣 農	衤 農
襝	衣 僉	衤 僉
襠	衣 當	衤 當
襤	衣 監	衤 監
襧	衣 爾	衤 爾
襩	衣 賣	衤 賣
襪	衣 蔑	衤 蔑
襬	衣 罷	衤 罷
襭	衣 頡	衤 頡
襯	衣 親	衤 親
襰	衣 賴	衤 賴
襱	衣 龍	衤 龍
襲	龍 衣
襴	衣 闌	衤 闌
襵	衣 聶	衤 聶
襸	衣 贊	衤 贊
襹	衣 麗	衤 麗
襺	衣 繭	衤 繭
襼	衣 藝	衤 藝
覇	西 革 月	覀 革 月
覊	西 革 馬	襾 革 馬	覀 革 馬
見	目 儿
覌	又 見
覍	小 見
覎	見 子
規	夫 見
覐	見 爻
覑	片 見
覒	毛 見
覓	爪 見	爫 見
覔	不 見
覕	必 見
視	示 見	礻 見
覗	司 見
覘	占 見
覙	尔 見
覚	小 冖 見
覛	厂 氏 見	𠂢 見
覜	兆 見
覝	干 火 見
覞	見 見
覟	志 見
覠	君 見
覡	巫 見
覢	炎 見
覣	委 見
覤	虎 見
覥	典 見
覦	俞 見
覧	臣 丿 一 丶 見	臣 丿 一 丶 見
覨	咢 見
覩	者 見
親	亲 見	立 木 見
覫	旁 見
覬	豈 見
覭	冥 見
覮	火 火 冖 見	𤇾 見
覯	冓 見
覰	虘 見
覱	斬 見
覲	堇 見
観	丿 二 隹 見
覵	閒 見
覶	爪 龴 冂 厶 又 見	爫 龴 冂 厶 又 見
覷	虛 見
覸	間 見
覹	見 微
覺	臼 爻 冖 見	𦥯 見
覻	虎 豆 見	虍 豆 見
覼	爾 見
覽	臣 丿 一 丶 网 見	臣 丿 一 丶 罒 見
覾	審 見
覿	賣 見
觀	雚 見
觔	角 力
觴	角 丿 一 昜
觵	角 黃
觶	角 單
觷	臼 爻 冖 角	𦥯 角
觸	角 蜀
觹	角 雋
觻	角 樂
觽	角 嶲
觿	角 巂
訁	丶 一 二 口
訂	言 丁	訁 丁
訃	言 卜	訁 卜
訄	九 言
訅	言 九	訁 九
訆	言 丩	訁 丩
計	言 十	訁 十
訉	言 凡	訁 凡
訊	言 卂	訁 卂
訋	言 勺	訁 勺
訌	言 工	訁 工
訍	言 叉	訁 叉
討	言 寸	訁 寸
訏	言 于	訁 于
訐	言 干	訁 干
訑	言 也	訁 也
訒	言 刃	訁 刃
訓	言 川	訁 川
訕	言 山	訁 山
訖	言 乞	訁 乞
託	言 乇	訁 乇
託	言 乇	訁 乇
記	言 己	訁 己
訙	言 丸	訁 丸
訛	言 化	訁 化
訜	言 分	訁 分
訝	言 牙	訁 牙
訞	言 夭	訁 夭
訟	言 公	訁 公
訠	言 引	訁 引
訡	言 今	訁 今
訢	言 斤	訁 斤
訣	言 夬	訁 夬
訤	言 爻	訁 爻
訥	言 內	訁 內
訦	言 冘	訁 冘
訧	言 尤	訁 尤
訨	言 止	訁 止
訩	言 凶	訁 凶
訪	言 方	訁 方
訫	言 心	訁 心
訬	言 少	訁 少
設	言 殳	訁 殳
訮	言 开	訁 开
訯	言 及	訁 及
訰	言 屯	訁 屯
許	言 午	訁 午
訲	言 中	訁 中
訳	言 尺	訁 尺
訴	言 斥	訁 斥
訵	言 四	訁 四
訶	言 可	訁 可
訷	言 申	訁 申
訸	言 禾	訁 禾
訹	言 朮	訁 朮
診	言 人 彡	訁 人 彡
註	言 主	訁 主
証	言 正	訁 正
訽	言 句	訁 句
訿	言 此	訁 此
詀	言 占	訁 占
詁	言 古	訁 古
詂	言 付	訁 付
詃	言 玄	訁 玄
詄	言 失	訁 失
詅	言 令	訁 令
詆	言 氐	訁 氐	言 氏 丶
詇	言 央	訁 央
詉	言 奴	訁 奴
詊	言 半	訁 半
詋	言 兄	訁 兄
詌	言 甘	訁 甘
詍	言 世	訁 世
詎	言 巨	訁 巨
詏	言 幼	訁 幼
詐	言 乍	訁 乍
詑	言 它	訁 它
詒	言 台	訁 台
詓	言 去	訁 去
詔	言 召	訁 召
評	言 平	訁 平
詖	言 皮	訁 皮
詗	言 冋	訁 冋
詘	言 出	訁 出
詙	言 犮	訁 犮
詚	言 旦	訁 旦
詛	言 且	訁 且
詜	言 山 又	訁 山 又	訁 屮 又
詝	言 宁	訁 宁
詞	言 司	訁 司
詠	言 永	訁 永
詡	言 羽	訁 羽
詢	言 旬	訁 旬
詣	言 旨	訁 旨
詤	言 亾 川	訁 亾 川
詥	言 合	訁 合
試	言 式	訁 式
詨	言 交	訁 交
詩	言 寺	訁 寺
詪	言 艮	訁 艮
詫	言 宅	訁 宅
詬	言 后	訁 后
詭	言 危	訁 危
詮	言 全	訁 全
詯	言 自	訁 自
詰	言 吉	訁 吉
話	言 舌	訁 舌
該	言 亥	訁 亥
詳	言 羊	訁 羊
詴	言 有	訁 有
詵	言 先	訁 先
詶	言 州	訁 州
詷	言 同	訁 同
詸	言 米	訁 米
詺	言 名	訁 名
詻	言 各	訁 各
詼	言 灰	訁 灰
詽	言 幵	訁 幵
詾	言 匈	訁 匈
詿	言 圭	訁 圭
誀	言 耳	訁 耳
誁	言 并	訁 并	言 幷	訁 幷
誂	言 兆	訁 兆
誃	言 多	訁 多
誄	言 耒	訁 耒
誅	言 朱	訁 朱
誆	言 匡	訁 匡
誇	言 夸	訁 夸
誈	言 至	訁 至
誋	言 忌	訁 忌
誌	言 志	訁 志
認	言 忍	訁 忍
誎	言 束	訁 束
誏	言 良	訁 良
誐	言 我	訁 我
誑	言 狂	訁 狂
誒	言 矣	訁 矣
誔	言 廷	訁 廷
誕	言 延	訁 延
誗	言 利	訁 利
誘	言 秀	訁 秀
誙	言 巠	訁 巠
誚	言 肖	訁 肖
誛	言 彐 冖 又	訁 彐 冖 又
誜	言 夋	訁 夋
誝	言 含	訁 含
語	言 吾	訁 吾
誟	言 孝	訁 孝
誠	言 成	訁 成
誡	言 戒	訁 戒
誢	言 見	訁 見
誣	言 巫	訁 巫
誤	言 吳	訁 吳
誥	言 告	訁 告
誦	言 甬	訁 甬
誧	言 甫	訁 甫
誨	言 每	訁 每
誩	言 言	訁 言
說	言 兌	訁 兌
誫	言 辰	訁 辰
説	言 兑	訁 兑
読	言 売	訁 売
誰	言 隹	訁 隹
課	言 果	訁 果
誳	言 屈	訁 屈
誴	言 宗	訁 宗
誵	言 肴	訁 肴
誶	言 卒	訁 卒
誷	言 罔	訁 罔
誸	言 弦	訁 弦
誹	言 非	訁 非
誺	言 來	訁 來
誻	言 沓	訁 沓
誼	言 宜	訁 宜
誽	言 兒	訁 兒
誾	門 言
調	言 周	訁 周
諀	言 卑	訁 卑
諁	言 叕	訁 叕
諂	言 臽	訁 臽
諃	言 林	訁 林
諄	言 享	訁 享
諆	言 其	訁 其
談	言 炎	訁 炎
諈	言 垂	訁 垂
諉	言 委	訁 委
諊	言 匊	訁 匊
請	言 青	訁 青
諌	言 東	訁 東
諍	言 爭	訁 爭
諎	言 昔	訁 昔
諏	言 取	訁 取
諑	言 豖	訁 豖
諒	言 京	訁 京
諓	言 戔	訁 戔
諔	言 叔	訁 叔
諕	言 虎	訁 虎
論	言 侖	訁 侖
諗	言 念	訁 念
諘	言 表	訁 表
諙	言 昏	訁 昏
諚	言 定	訁 定
諛	言 臾	訁 臾
諜	言 枼	訁 枼	言 世 木
諝	言 胥	訁 胥
諞	言 扁	訁 扁
諟	言 是	訁 是
諠	言 宣	訁 宣
諡	言 兮 皿	訁 兮 皿
諢	言 軍	訁 軍
諣	言 咼	訁 咼
諤	言 咢	訁 咢
諥	言 重	訁 重
諦	言 帝	訁 帝
諧	言 皆	訁 皆
諨	言 畐	訁 畐
諩	言 並	訁 並
諪	言 亭	訁 亭
諫	言 柬	訁 柬
諭	言 俞	訁 俞
諮	言 咨	訁 咨
諯	言 耑	訁 耑
諰	言 思	訁 思
諱	言 韋	訁 韋
諲	言 垔	訁 垔
諳	言 音	訁 音
諴	言 咸	訁 咸
諵	言 南	訁 南
諶	言 甚	訁 甚
諷	言 風	訁 風
諸	言 者	訁 者
諹	言 昜	訁 昜
諺	言 彦	訁 彦
諻	言 皇	訁 皇
諼	言 爰	訁 爰
諽	言 革	訁 革
諾	言 若	訁 若
諿	言 咠	訁 咠
謀	言 某	訁 某
謁	言 曷	訁 曷
謂	言 胃	訁 胃
謄	月 誊
謅	言 芻	訁 芻
謆	言 扇	訁 扇
謊	言 荒	訁 荒
謋	言 桀	訁 桀
謌	言 哥	訁 哥
謎	言 迷	訁 迷
謏	言 叟	訁 叟
謐	言 必 皿	訁 必 皿
謑	言 奚	訁 奚
謒	言 倉	訁 倉
謓	言 真	訁 真
謔	言 虐	訁 虐
謕	言 虒	訁 虒
謖	言 畟	訁 畟
謗	言 旁	訁 旁
謘	言 屖	訁 屖
謙	言 兼	訁 兼
謚	言 益	訁 益
講	言 冓	訁 冓
謜	言 原	訁 原
謝	言 射	訁 射
謞	言 高	訁 高
謟	言 舀	訁 舀
謠	言 月 缶	訁 月 缶	言 䍃	訁 䍃
謡	言 爪 击	訁 爫 击
謣	言 雩	訁 雩
謤	言 票	訁 票
謥	言 悤	訁 悤
謧	言 离	訁 离
謨	言 莫	訁 莫
謪	言 商	訁 商
謫	言 啇	訁 啇
謬	言 翏	訁 翏
謭	言 剪	訁 剪
謮	言 責	訁 責
謯	言 虘	訁 虘
謰	言 連	訁 連
謱	言 婁	訁 婁
謲	言 參	訁 參
謳	言 區	訁 區
謴	言 貫	訁 貫
謵	言 習	訁 習
謶	言 庶	訁 庶
謸	言 敖	訁 敖
謹	言 堇	訁 堇
謺	執 言
謻	言 移	訁 移
謼	言 虖	訁 虖
謾	言 曼	訁 曼
謿	言 朝	訁 朝
譁	言 華	訁 華
譂	言 單	訁 單
譃	言 虛	訁 虛
譄	言 曾	訁 曾
譅	言 歰	訁 歰
譆	言 喜	訁 喜
譇	言 奢	訁 奢
譈	言 敦	訁 敦
證	言 登	訁 登
譊	言 堯	訁 堯
譋	言 閒	訁 閒
譌	言 爲	訁 爲	言 為	訁 為
譎	言 矞	訁 矞
譏	言 幾	訁 幾
譐	言 尊	訁 尊
譑	言 喬	訁 喬
譒	言 番	訁 番
譓	言 惠	訁 惠
譔	言 巽	訁 巽
譕	言 無	訁 無
譖	言 旡 旡 日	訁 旡 旡 日	言 朁	訁 朁
譗	言 答	訁 答
識	言 戠	訁 戠
譙	言 焦	訁 焦
譚	言 覃	訁 覃
譛	言 替	訁 替
譜	言 普	訁 普
譝	言 黽	訁 黽
譞	言 睘	訁 睘
譟	言 喿	訁 喿
譠	言 亶	訁 亶
譡	言 當	訁 當
譢	言 遂	訁 遂
譣	言 僉	訁 僉
譤	言 敫	訁 敫
譧	言 廉	訁 廉
譨	言 農	訁 農
譩	言 意	訁 意
譪	言 葛	訁 葛
譫	言 詹	訁 詹
譭	言 毀	訁 毀
譮	言 會	訁 會
譯	言 睪	訁 睪
議	言 義	訁 義
譲	言 衣 八 井 一	訁 衣 八 井 一
譳	言 需	訁 需
譴	言 遣	訁 遣
譵	言 對	訁 對
護	言 蒦	訁 蒦
譸	言 壽	訁 壽
譹	言 豪	訁 豪
譺	言 疑	訁 疑
譻	賏 言
譼	臣 丿 一 丶 网 言	臣 丿 一 丶 罒 言
譽	與 言
譾	言 翦	訁 翦
譿	言 慧	訁 慧
讀	言 賣	訁 賣
讁	言 適	訁 適
讂	言 夐	訁 夐
讃	言 賛	訁 賛
讄	言 畾	訁 畾
讅	言 審	訁 審
讆	衛 言
讇	言 閻	訁 閻
讈	言 歷	訁 歷
讉	言 遺	訁 遺
變	絲 言 夕	糸 言 糸 夕	絲 言 夂	䜌 夕	䜌 夂
讋	龍 言
讌	言 燕	訁 燕
讍	言 噩	訁 噩
讎	隹 言 隹	雔 言	隹 訁 隹
讏	衞 言
讑	言 龠	訁 龠
讒	言 毚	訁 毚
讓	言 襄	訁 襄
讔	言 隱	訁 隱
讕	言 闌	訁 闌
讖	言 韱	訁 韱
讗	言 巂	訁 巂
讘	言 聶	訁 聶
讚	言 贊	訁 贊
讛	言 藝	訁 藝
讜	言 黨	訁 黨
讝	言 嚴	訁 嚴
讞	言 獻	訁 獻
讟	言 賣 言
豄	谷 賣
豅	谷 龍
豈	山 豆
豎	臤 豆
豐	山 丰 丰 豆
豬	豕 者
豵	豕 從
豶	豕 賁
貍	豸 里	犭 里 狸
貓	豕 苗
貗	豸 婁
貘	豸 莫
貙	豸 區
貚	豸 單
貛	豸 雚
貝	目 八
貞	卜 貝
貟	厶 貝
負	刀 貝
財	貝 才
貢	工 貝
貤	貝 也
貥	貝 亢
貦	貝 元
貧	分 貝
貨	化 貝
販	貝 反
貪	今 貝
貫	母 貝
責	丰 貝
貭	盾 八	厂 十 貝	厂 真
貮	一 弋 貝
貯	貝 宁
貰	世 貝
貲	此 貝
貳	弋 二 貝
貴	中 一 貝
貵	厶 大 貝
貶	貝 乏
買	网 貝	罒 貝	罓 貝
貸	代 貝
貹	貝 生
貺	貝 兄
費	弗 貝
貼	貝 占
貽	貝 台
貾	貝 氐
貿	卯 貝
賀	加 貝
賁	十 十 十 貝
賂	貝 各
賃	任 貝
賄	貝 有
賅	貝 亥
賆	貝 并	貝 幷
資	次 貝
賈	西 貝	覀 貝	襾 貝
賉	貝 血
賊	貝 戎
賋	貝 交
賌	亥 貝
賍	貝 庄
賎	貝 一 戋
賏	貝 貝
賐	貝 夋
賑	貝 辰
賒	貝 佘
賓	宀 一 少 貝
賕	貝 求
賖	貝 余
賗	貝 串
賘	貝 广 圡
賙	貝 周
賚	來 貝
賛	夫 夫 貝
賜	貝 易
賝	貝 罙
賞	尚 貝
賟	貝 典
賠	貝 咅
賡	庚 貝
賢	臤 貝
賣	士 買
賤	貝 戔
賥	貝 卒
賦	貝 武
賧	貝 炎
賨	宗 貝
賩	貝 宗
質	斤 斤 貝
賫	十 人 人 冖 貝
賬	貝 長
賭	貝 者
賮	聿 火 貝	聿 灬 貝
賯	貝 旬 子
賰	貝 春
賱	貝 軍
賲	保 貝
賳	貝 哉
賴	束 負
賵	貝 冒
賶	貝 倉
賷	十 口 口 冖 貝
賸	肉 丷 夫 貝	月 丷 夫 貝	肉 𠔉 貝	月 𠔉 貝
賹	貝 益
賺	貝 兼
賻	貝 専	貝 尃
購	貝 冓
賽	宀 井 大 貝
賿	貝 翏
贀	殹 貝
贁	貝 貝 攴	貝 貝 攵
贂	貝 參
贃	貝 患
贄	執 貝
贅	敖 貝
贆	貝 猋
贇	斌 貝
贈	貝 曽	貝 曾
贉	貝 覃
贊	先 先 貝
贋	厂 人 隹 貝	厂 亻 隹 貝	厂 倠 貝
贍	貝 詹
贎	貝 萬
贏	亡 口 月 貝 凡
贐	貝 盡
贑	章 貢
贒	臣 忠 貝
贓	貝 臧
贔	貝 貝 貝
贕	卵 賣
贖	貝 賣
贗	厂 人 鳥 貝	厂 亻 鳥 貝
贙	虎 虎 貝
贚	貝 龍
贛	立 早 夕 工 貝	立 早 夂 工 貝
贜	貝 藏
赨	赤 蟲	赤 虫
赬	赤 貞
赹	走 勻
趕	走 旱
趙	走 肖
趨	走 芻
趪	走 黃
趫	走 喬
趬	走 堯
趲	走 贊
跚	足 冊
跡	足 亦
跥	足 朶
踁	足 巠
踐	足 戔
踚	足 侖
踭	足 爭
踴	足 勇
踻	足 咼
踼	足 昜
蹌	足 倉
蹕	足 畢
蹛	足 帶
蹞	足 頃
蹟	足 責
蹡	足 將
蹣	足 廿 冂 丨 入 入	足 㒼
蹤	足 從
蹥	足 連
蹪	足 貴
蹳	足 發
蹺	足 堯
蹻	足 喬
躀	足 貫
躂	足 達
躉	萬 足
躊	足 壽
躋	足 齊
躍	足 翟
躎	足 爾
躑	足 鄭
躒	足 樂
躓	足 質
躕	足 廚
躗	衛 足
躘	足 龍
躙	足 閵
躚	足 遷
躝	足 闌
躡	足 聶
躢	足 闒
躥	足 竄
躦	足 贊
躧	足 麗
躪	足 藺
躱	身 朶
軀	身 區
軁	身 婁
軂	身 勞
軃	身 單
軄	身 戠
軇	身 壽
軉	身 寶
車	一 日 十
軋	車 乚
軌	車 九
軍	冖 車
軎	車 口
軏	車 兀
軐	車 卂
軑	車 大
軒	車 干
軓	車 凡
軔	車 刃
軕	車 山
軖	車 王
軗	車 殳
軘	車 屯
軙	車 攴	車 攵
軚	車 太
軛	車 厄
軜	車 內
軝	車 氏
軞	車 毛
軟	車 欠
軠	車 壬
軡	車 今
転	車 云
軣	車 丷 八
軤	車 乎
軥	車 句
軦	車 兄
軧	車 氐
軨	車 令
軪	車 幼
軫	車 人 彡
軬	厶 大 車
軭	車 匡
軮	車 央
軯	車 平
軰	北 車
軱	車 瓜
軲	車 古
軳	車 包
軴	車 主
軵	車 付
軶	車 戹
軷	車 犮
軸	車 由
軹	車 只
軺	車 召
軻	車 可
軼	車 失
軽	車 圣
軾	車 式
軿	車 并	車 幷
輀	車 而
輁	車 共
輂	共 車
較	車 交
輄	車 光
輅	車 各
輆	車 亥
輇	車 全
輈	車 舟
載	十 戈 車	土 戈 車	𢦏 車
輊	車 至
輋	山 大 車
輌	車 両
輍	車 谷
輎	車 肖
輏	車 酉
輐	車 完
輑	車 君
輒	車 耴
輓	車 免
輔	車 甫
輕	車 巠
輖	車 周
輗	車 兒
輘	車 夌
輙	車 取
輚	車 戔
輛	車 兩
輜	車 甾
輝	車 軍
輞	車 罔
輟	車 叕
輠	車 果
輡	車 臽
輢	車 奇
輣	車 朋
輤	車 青
輥	車 昆
輦	夫 夫 車
輧	車 幷
輨	車 官
輩	非 車
輪	車 侖
輫	車 非
輬	車 京
輭	車 耎
輮	車 柔
輯	車 咠	車 口 耳
輰	車 昜
輱	車 咸
輲	車 耑
輳	車 奏
輴	車 盾
輵	車 曷
輶	車 酋
輷	車 訇
輸	車 俞
輹	車 复
輺	車 甾 一
輻	車 畐
輼	車 昷
輽	車 畚
輾	車 展
輿	臼 車 一 八
轀	車 昷
轁	車 舀
轂	士 冖 一 車 殳
轃	車 秦
轄	車 害
轅	車 袁
轆	車 鹿
轇	車 翏
轈	車 巢
轉	車 專
轊	車 彗
轋	車 連
轍	車 彳 育 攵
轎	車 喬
轏	車 孱
轐	車 菐
轑	車 尞
轒	車 賁
轓	車 番
轔	車 粦
轕	車 葛
轖	車 嗇
轗	車 感
轘	車 睘
轙	車 義
轚	車 凵 殳
轛	車 對
轜	車 需
轝	與 車
轞	車 監
轟	車 車 車
轠	車 畾
轡	絲 車 口
轢	車 樂
轣	車 歷
轤	車 盧
轥	車 藺
辦	辛 力 辛
辭	爪 龴 冂 厶 又 辛	爫 龴 冂 厶 又 辛
辮	辛 絲 辛	辛 糸 辛
辯	辛 言 辛	辛 訁 辛
農	曲 辰
辴	單 辰
辺	辵 刀	辶 刀
迊	辵 币	辶 币
迴	辵 回	辶 回
迺	辵 西	辶 西
逕	辵 巠	辶 巠
逕	辵 巠	辶 巠
這	辵 言	辶 言
連	辵 車	辶 車
逥	辵 囬	辶 囬
逨	辵 來	辶 來
逬	辵 幷	辶 幷
週	辵 周	辶 周
進	辵 隹	辶 隹
逺	辵 土 𠃊 	辶 土 𠃊 
逿	辵 昜	辶 昜
遀	辵 左 月	辶 左 月
遊	辵 斿	辶 斿
運	辵 軍	辶 軍
過	辵 咼	辶 咼
達	辵 土 羊	辶 土 羊	辵 幸	辶 幸
違	辵 韋	辶 韋
遙	辵 月 缶	辶 月 缶	辵 䍃	辶 䍃
遜	辵 孫	辶 孫
遞	辵 厂 虎	辶 厂 虎
遠	辵 袁	辶 袁
遦	辵 貫	辶 貫
適	辵 啇	辶 啇
遪	辵 參	辶 參
遰	辵 帶	辶 帶
遱	辵 婁	辶 婁
遲	辵 犀	辶 犀
遶	辵 堯	辶 堯
遷	辵 西 大 己	辶 覀 大 己
選	辵 巽	辶 巽
遺	辵 貴	辶 貴
遼	辵 尞	辶 尞
邁	辵 萬	辶 萬
還	辵 睘	辶 睘
邇	辵 爾	辶 爾
邊	辵 自 穴 方	辶 自 穴 方	辵 臱	辶 臱
邏	辵 羅	辶 羅
邐	辵 麗	辶 麗
郘	呂 邑	呂 阝
郟	夾 邑	夾 阝
郥	貝 邑	貝 阝
郲	來 邑	來 阝
郵	垂 邑	垂 阝
郼	韋 邑	韋 阝
鄆	軍 邑	軍 阝
鄉	乡 郎
鄑	晉 邑	晉 阝
鄒	芻 邑	芻 阝
鄔	烏 邑	烏 阝
鄕	乡 郎 邑	乡 郎 阝
鄖	員 邑	員 阝
鄟	專 邑	專 阝
鄡	梟 邑	梟 阝
鄥	鳥 邑	鳥 阝
鄦	無 邑	無 阝
鄧	登 邑	登 阝
鄩	尋 邑	尋 阝
鄪	費 邑	費 阝
鄬	為 邑	為 阝
鄭	奠 邑	阝 邑
鄮	冒 邑	冒 阝
鄰	粦 邑	粦 阝
鄲	單 邑	單 阝
鄳	黽 邑	黽 阝
鄴	業 邑	業 阝
鄶	會 邑	會 阝
鄸	夢 邑	夢 阝
鄺	廣 邑	廣 阝
鄻	輦 邑	輦 阝
鄼	賛 邑	賛 阝
鄿	蕇 邑	蕇 阝
酇	贊 邑	贊 阝
酈	麗 邑	麗 阝
醃	酉 奄
醗	酉 発
醜	酉 鬼
醞	酉 昷
醟	火 火 冖 酉	𤇾 酉
醤	将 酉
醦	酉 參
醧	酉 區
醫	殹 酉
醬	將 酉
醱	酉 發
醲	酉 農
醶	酉 僉
醻	酉 壽
釀	酉 襄
釁	臼 同 冖 酉 分
釃	酉 麗
釅	酉 嚴
釈	釆 尺
釋	采 睪	釆 睪
釐	未 攴 厂 里	未 攵 厂 里
釒	人 王 丷
釓	金 乚	釒 乚
釔	金 乙	釒 乙
釕	金 了	釒 了
釖	金 刀	釒 刀
釗	金 刀	釒 刂
釘	金 丁	釒 丁
釙	金 卜	釒 卜
釚	金 九	釒 九
釛	金 力	釒 力
針	金 十	釒 十
釞	金 入	釒 入
釟	金 八	釒 八
釠	金 几	釒 几
釢	金 乃	釒 乃
釣	金 勺	釒 勺
釤	金 彡	釒 彡
釥	金 小	釒 小
釦	金 口	釒 口
釧	金 川	釒 川
釨	金 子	釒 子
釩	金 凡	釒 凡
釪	金 于	釒 于
釫	金 亏	釒 亏
釬	金 干	釒 干
釮	金 才	釒 才
釯	金 亡	釒 亡
釰	金 刃	釒 刃
釱	金 大	釒 大
釲	金 巳	釒 巳
釳	金 乞	釒 乞
釴	金 弋	釒 弋
釵	金 叉	釒 叉
釶	金 也	釒 也
釷	金 土	釒 土
釸	金 夕	釒 夕
釹	金 女	釒 女
釺	金 千	釒 千
釼	金 刄	釒 刄
釽	金 爪	釒 爪
釾	金 牙	釒 牙
釿	金 斤	釒 斤
鈀	金 巴	釒 巴
鈁	金 方	釒 方
鈂	金 冘	釒 冘
鈃	金 开	釒 开
鈄	金 斗	釒 斗
鈅	金 月	釒 月
鈆	金 公	釒 公
鈇	金 夫	釒 夫
鈈	金 不	釒 不
鈉	金 內	釒 內
鈊	金 心	釒 心
鈋	金 化	釒 化
鈌	金 夬	釒 夬
鈍	金 屯	釒 屯
鈎	金 勾	釒 勾
鈏	金 引	釒 引
鈐	金 今	釒 今
鈑	金 反	釒 反
鈒	金 及	釒 及
鈓	金 壬	釒 壬
鈔	金 少	釒 少
鈕	金 丑	釒 丑
鈖	金 分	釒 分
鈗	金 允	釒 允
鈘	金 支	釒 支
鈙	金 攴	釒 攴
鈚	金 比	釒 比
鈛	金 戈	釒 戈
鈜	金 厷	釒 厷
鈝	金 牛	釒 牛
鈞	金 勻	釒 勻
鈟	金 弔	釒 弔
鈠	金 殳	釒 殳
鈡	金 中	釒 中
鈢	金 木	釒 木
鈣	金 丐	釒 丐
鈤	金 日	釒 日
鈥	金 火	釒 火
鈦	金 太	釒 太
鈧	金 亢	釒 亢
鈪	金 厄	釒 厄
鈬	金 尺	釒 尺
鈭	此 金
鈮	金 尼	釒 尼
鈯	金 出	釒 出
鈰	金 市	釒 市
鈱	金 民	釒 民
鈲	金 瓜	釒 瓜
鈳	金 可	釒 可
鈴	金 令	釒 令
鈵	金 丙	釒 丙
鈶	金 台	釒 台
鈷	金 古	釒 古
鈸	金 犮	釒 犮
鈹	金 皮	釒 皮
鈺	金 玉	釒 玉
鈻	金 尸 乛 一	釒 尸 乛 一
鈼	金 乍	釒 乍
鈽	金 布	釒 布
鈾	金 由	釒 由
鈿	金 田	釒 田
鉀	金 甲	釒 甲
鉁	金 人 彡	釒 人 彡
鉂	金 史	釒 史
鉃	金 矢	釒 矢
鉄	金 失	釒 失
鉅	金 巨	釒 巨
鉆	金 占	釒 占
鉇	金 丿 一 也	釒 丿 一 也
鉈	金 它	釒 它
鉉	金 玄	釒 玄
鉊	金 召	釒 召
鉋	金 包	釒 包
鉌	金 禾	釒 禾
鉍	金 必	釒 必
鉎	金 生	釒 生
鉐	金 石	釒 石
鉑	金 白	釒 白
鉒	金 主	釒 主
鉓	金 丿 一 巾	釒 丿 一 巾	金 布	釒 布
鉔	金 匝	釒 匝
鉕	金 叵	釒 叵
鉖	金 冬	釒 冬
鉗	金 甘	釒 甘
鉘	金 弗	釒 弗
鉙	金 只	釒 只
鉚	金 卯	釒 卯
鉛	金 八 口	釒 八 口
鉜	金 付	釒 付
鉝	金 立	釒 立
鉞	金 戉	釒 戉
鉟	金 丕	釒 丕
鉠	金 央	釒 央
鉡	金 半	釒 半
鉢	金 本	釒 本
鉤	金 句	釒 句
鉥	金 朮	釒 朮
鉦	金 正	釒 正
鉧	金 母	釒 母
鉨	金 尔	釒 尔
鉩	金 尒	釒 尒
鉪	金 世	釒 世
鉫	金 加	釒 加
鉬	金 目	釒 目
鉭	金 旦	釒 旦
鉮	金 申	釒 申
鉯	金 以	釒 以
鉰	金 司	釒 司
鉱	金 広	釒 広
鉲	金 卡	釒 卡
鉳	金 北	釒 北
鉵	金 蟲	釒 蟲	金 虫	釒 虫
鉶	金 刑	釒 刑
鉷	金 共	釒 共
鉸	金 交	釒 交
鉹	金 多	釒 多
鉺	金 耳	釒 耳
鉻	金 各	釒 各
鉼	金 并	釒 并	金 幷	釒 幷
鉽	金 式	釒 式
鉾	金 牟	釒 牟
鉿	金 合	釒 合
銀	金 艮	釒 艮
銁	金 旬	釒 旬
銂	金 州	釒 州
銃	金 充	釒 充
銄	金 向	釒 向
銅	金 同	釒 同
銆	金 百	釒 百
銇	金 耒	釒 耒
銈	金 圭	釒 圭
銉	金 聿	釒 聿
銊	金 戌	釒 戌
銋	金 任	釒 任
銌	金 存	釒 存
銍	金 至	釒 至
銎	金 巩	釒 巩
銏	金 册	釒 册
銑	金 先	釒 先
銒	金 幵	釒 幵
銓	金 全	釒 全
銔	金 不 十	釒 不 十
銕	金 夷	釒 夷
銖	金 朱	釒 朱
銗	金 后	釒 后
銘	金 名	釒 名
銙	金 夸	釒 夸
銚	金 兆	釒 兆
銛	金 舌	釒 舌
銜	行 金	行 釒
銝	金 休	釒 休
銞	旬 金
銟	金 山 巾	釒 山 巾
銠	金 老	釒 老
銡	金 吉	釒 吉
銢	金 二 水	釒 二 水
銣	金 如	釒 如
銤	金 米	釒 米
銥	金 衣	釒 衣
銦	金 因	釒 因
銧	金 光	釒 光
銨	金 安	釒 安
銩	金 丟	釒 丟
銪	金 有	釒 有
銫	金 色	釒 色
銬	金 考	釒 考
銭	金 一 戋	釒 一 戋
銰	金 艾	釒 艾
銱	金 吊	釒 吊
銲	金 旱	釒 旱
銳	金 兌	釒 兌
銴	折 金
銵	金 身	釒 身
銶	金 求	釒 求
銷	金 肖	釒 肖
銸	金 耴	釒 耴
銹	金 秀	釒 秀
銺	壯 金
銻	金 弟	釒 弟
銼	金 坐	釒 坐
銽	金 氏 口	釒 氏 口
銾	金 汞	釒 汞
銿	金 甬	釒 甬
鋀	金 豆	釒 豆
鋁	金 呂	釒 呂
鋂	金 每	釒 每
鋃	金 良	釒 良
鋄	金 灭 又	釒 灭 又
鋅	金 辛	釒 辛
鋆	均 金
鋇	金 貝	釒 貝
鋈	沃 金
鋉	金 束	釒 束
鋊	金 谷	釒 谷
鋋	金 延	釒 延
鋌	金 廷	釒 廷
鋍	金 孛	釒 孛
鋎	金 完	釒 完
鋏	金 夾	釒 夾
鋐	金 宏	釒 宏
鋑	金 夋	釒 夋
鋒	金 夆	釒 夆
鋓	金 利	釒 利
鋔	金 免	釒 免
鋕	金 志	釒 志
鋖	金 妥	釒 妥
鋗	金 肙	釒 肙
鋘	金 吳	釒 吳
鋙	金 吾	釒 吾
鋚	攸 金
鋛	金 串	釒 串
鋜	金 足	釒 足
鋝	金 寽	釒 寽
鋞	金 巠	釒 巠
鋟	金 彐 冖 又	釒 彐 冖 又
鋠	金 辰	釒 辰
鋡	金 含	釒 含
鋢	金 孚	釒 孚
鋣	金 邪	釒 邪
鋤	金 助	釒 助
鋥	金 呈	釒 呈
鋦	金 局	釒 局
鋧	金 見	釒 見
鋨	金 我	釒 我
鋩	金 芒	釒 芒
鋪	金 甫	釒 甫
鋫	利 金
鋬	扳 金
鋭	金 兑	釒 兑
鋮	金 成	釒 成
鋯	金 告	釒 告
鋰	金 里	釒 里
鋱	金 忒	釒 忒
鋳	金 寿	釒 寿
鋵	金 禿	釒 禿
鋶	金 亠 厶 川	釒 亠 厶 川	金 巟	釒 巟	金 㐬	釒 㐬
鋷	金 取	釒 取
鋸	金 居	釒 居
鋹	金 長	釒 長
鋺	金 宛	釒 宛
鋼	金 岡	釒 岡
鋽	金 卓	釒 卓
鋾	金 匋	釒 匋
鋿	金 尚	釒 尚
錀	金 侖	釒 侖
錁	金 果	釒 果
錂	金 夌	釒 夌
錄	金 彔	釒 彔
錆	金 青	釒 青
錇	金 咅	釒 咅
錈	金 卷	釒 卷
錉	金 昏	釒 昏
錊	金 卒	釒 卒
錋	金 朋	釒 朋
錌	金 岸	釒 岸
錍	金 卑	釒 卑
錎	金 臽	釒 臽
錏	金 亞	釒 亞
錐	金 隹	釒 隹
錑	金 戾	釒 戾
錒	金 阿	釒 阿
錓	金 羌	釒 羌
錔	金 沓	釒 沓
錕	金 昆	釒 昆
錗	金 委	釒 委
錘	金 垂	釒 垂
錙	金 甾	釒 甾
錚	金 爭	釒 爭
錛	金 奔	釒 奔
錜	金 念	釒 念
錝	金 宗	釒 宗
錞	金 享	釒 享
錟	金 炎	釒 炎
錠	金 定	釒 定
錡	金 奇	釒 奇
錢	金 戔	釒 戔
錣	金 叕	釒 叕
錤	金 其	釒 其
錥	金 育	釒 育
錦	金 帛	釒 帛
錧	金 官	釒 官
錨	金 苗	釒 苗
錩	金 昌	釒 昌
錪	金 典	釒 典
錫	金 易	釒 易
錬	金 東	釒 東
錭	金 周	釒 周
錮	金 固	釒 固
錯	金 昔	釒 昔
錰	金 杰	釒 杰
錱	金 王 王
録	金 录	釒 录
錳	金 孟	釒 孟
錴	金 坴	釒 坴
錵	金 花	釒 花
錶	金 表	釒 表
錷	金 軋	釒 軋
錸	金 來	釒 來
錹	金 肯	釒 肯
錼	金 奈	釒 奈
錽	金 灭 夕	釒 灭 夂
鍀	金 日 一 寸	釒 日 一 寸	金 㝵	釒 㝵
鍁	金 欣	釒 欣
鍃	金 忽	釒 忽
鍄	金 京	釒 京
鍆	金 門	釒 門
鍇	金 皆	釒 皆
鍈	金 英	釒 英
鍉	金 是	釒 是
鍊	金 柬	釒 柬
鍋	金 咼	釒 咼
鍌	洗 金
鍍	金 度	釒 度
鍎	金 盾	釒 盾
鍏	金 韋	釒 韋
鍐	金 凶 儿 夕	釒 凶 儿 夂
鍑	金 复	釒 复
鍒	金 柔	釒 柔
鍓	金 咠	釒 咠
鍔	金 咢	釒 咢
鍕	金 軍	釒 軍
鍖	金 甚	釒 甚
鍗	金 帝	釒 帝
鍘	金 則	釒 則
鍚	金 昜	釒 昜
鍛	金 段	釒 段
鍜	金 叚	釒 叚
鍝	金 禺	釒 禺
鍞	金 貞	釒 貞
鍟	金 星	釒 星
鍠	金 皇	釒 皇
鍡	金 畏	釒 畏
鍢	金 畐	釒 畐
鍣	金 苕	釒 苕
鍤	金 臿	釒 臿
鍥	金 契	釒 契
鍦	金 施	釒 施
鍧	金 訇	釒 訇
鍨	金 癸	釒 癸
鍩	金 若	釒 若
鍪	敄 金
鍫	秋 金
鍬	金 秋	釒 秋
鍭	金 侯	釒 侯
鍮	金 俞	釒 俞
鍯	金 怱	釒 怱
鍰	金 爰	釒 爰
鍱	金 枼	釒 枼
鍲	金 昬	釒 昬
鍴	金 耑	釒 耑
鍵	金 建	釒 建
鍶	金 思	釒 思
鍷	金 奎	釒 奎
鍸	金 胡	釒 胡
鍹	金 宣	釒 宣
鍺	金 者	釒 者
鍻	金 曷	釒 曷
鍼	金 咸	釒 咸
鍽	金 扁	釒 扁
鍾	金 重	釒 重
鍾	金 重	釒 重
鍿	金 甾 一	釒 甾 一
鎀	金 修	釒 修
鎁	金 耶	釒 耶
鎂	金 美	釒 美
鎃	金 派	釒 派
鎄	金 哀	釒 哀
鎅	金 界	釒 界
鎇	金 眉	釒 眉
鎈	金 差	釒 差
鎉	金 日 羽	釒 日 羽
鎊	金 旁	釒 旁
鎋	金 害	釒 害
鎌	金 廉	釒 廉
鎍	金 索	釒 索
鎎	金 氣	釒 氣
鎏	流 金
鎐	金 爪 缶	釒 爫 缶
鎑	金 盍	釒 盍
鎒	金 辱	釒 辱
鎓	金 翁	釒 翁
鎔	金 容	釒 容
鎕	金 唐	釒 唐
鎖	金 小 貝	釒 小 貝
鎗	金 倉	釒 倉
鎘	金 鬲	釒 鬲
鎙	金 朔	釒 朔
鎚	金 追	釒 追
鎛	金 尃	釒 尃
鎜	般 金
鎝	金 荅	釒 荅
鎞	金 囟 比	釒 囟 比
鎟	金 桑	釒 桑
鎠	金 罡	釒 罡
鎡	金 兹	釒 兹
鎢	金 烏	釒 烏
鎣	火 火 冖 金	𤇾 金
鎤	金 晃	釒 晃
鎥	條 金
鎦	金 留	釒 留
鎧	金 豈	釒 豈
鎨	金 隼	釒 隼
鎩	金 殺	釒 殺
鎪	金 叟	釒 叟
鎫	金 丶 冂 乂 八 夕	釒 丶 冂 乂 八 夂
鎬	金 高	釒 高
鎭	金 眞	釒 眞
鎮	金 真	釒 真
鎯	金 郎	釒 郎
鎰	金 益	釒 益
鎱	金 袁	釒 袁
鎲	金 党	釒 党
鎳	金 臬	釒 臬
鎴	金 息	釒 息
鎵	金 家	釒 家
鎶	金 哥	釒 哥
鎷	金 馬	釒 馬
鎸	金 隽	釒 隽
鎻	金 巛 貝	釒 巛 貝
鎿	金 拿	釒 拿
鏀	金 鹵	釒 鹵
鏁	金 巢	釒 巢
鏂	金 區	釒 區
鏃	金 族	釒 族
鏄	金 專	釒 專
鏅	金 脩	釒 脩
鏆	金 貫	釒 貫
鏇	金 旋	釒 旋
鏈	金 連	釒 連
鏉	金 欶	釒 欶
鏋	金 廿 冂 丨 入 入	釒 廿 冂 丨 入 入	金 㒼	釒 㒼
鏌	金 莫	釒 莫
鏍	金 累	釒 累
鏎	金 畢	釒 畢
鏏	金 彗	釒 彗
鏐	金 翏	釒 翏
鏑	金 啇	釒 啇
鏒	金 參	釒 參
鏓	金 悤	釒 悤
鏔	金 寅	釒 寅
鏕	金 鹿	釒 鹿
鏗	金 堅	釒 堅
鏘	金 將	釒 將
鏙	金 崔	釒 崔
鏚	金 戚	釒 戚
鏛	金 常	釒 常
鏜	金 堂	釒 堂
鏝	金 曼	釒 曼
鏞	金 庸	釒 庸
鏟	金 產	釒 產
鏠	金 逢	釒 逢
鏡	金 竟	釒 竟
鏢	金 票	釒 票
鏣	金 庶	釒 庶
鏤	金 婁	釒 婁
鏥	金 宿	釒 宿
鏦	金 從	釒 從
鏧	殸 金
鏨	斬 金
鏩	金 斬	釒 斬
鏪	金 曹	釒 曹
鏫	金 梨	釒 梨
鏬	金 虖	釒 虖
鏭	金 悉	釒 悉
鏮	金 康	釒 康
鏰	金 朋	釒 朋
鏳	金 曾	釒 曾
鏴	金 路	釒 路
鏵	金 華	釒 華
鏶	金 集	釒 集
鏷	金 菐	釒 菐
鏸	金 惠	釒 惠
鏹	金 強	釒 強
鏺	金 發	釒 發
鏻	金 粦	釒 粦
鏼	金 策	釒 策
鏽	金 肅	釒 肅
鏾	金 散	釒 散
鏿	金 棠	釒 棠
鐀	金 貴	釒 貴
鐁	金 斯	釒 斯
鐂	金 畱	釒 畱
鐃	金 堯	釒 堯
鐄	金 黃	釒 黃
鐅	敝 金
鐆	隊 金
鐇	金 番	釒 番
鐈	金 喬	釒 喬
鐉	金 巽	釒 巽
鐊	金 陽	釒 陽
鐋	金 湯	釒 湯
鐌	金 象	釒 象
鐍	金 矞	釒 矞
鐎	金 焦	釒 焦
鐏	金 尊	釒 尊
鐐	金 尞	釒 尞 镣
鐑	金 結	釒 結
鐒	金 勞	釒 勞
鐓	金 敦	釒 敦
鐔	金 覃	釒 覃
鐕	金 旡 旡 日	釒 旡 旡 日	金 朁	釒 朁
鐖	金 幾	釒 幾
鐗	金 閒	釒 閒
鐘	金 童	釒 童
鐙	金 登	釒 登
鐚	金 惡	釒 惡
鐛	金 景	釒 景
鐝	金 厥	釒 厥
鐞	金 尋	釒 尋
鐟	金 替	釒 替
鐠	金 普	釒 普
鐡	金 十 豆 戈	釒 十 豆 戈
鐤	金 鼎	釒 鼎
鐥	金 善	釒 善
鐦	金 開	釒 開
鐧	金 間	釒 間
鐨	金 費	釒 費
鐩	金 遂	釒 遂
鐪	金 虜	釒 虜
鐫	金 雋	釒 雋
鐬	金 歲	釒 歲
鐭	金 奥	釒 奥
鐮	金 廉	釒 廉
鐯	金 著	釒 著
鐰	金 喿	釒 喿
鐱	金 僉	釒 僉
鐲	金 蜀	釒 蜀
鐳	金 雷	釒 雷
鐴	金 辟	釒 辟
鐵	金 哉 王	釒 哉 王	金 土 口 王 戈	釒 土 口 王 戈
鐶	金 睘	釒 睘
鐷	金 葉	釒 葉
鐸	金 睪	釒 睪
鐹	金 過	釒 過
鐺	金 當	釒 當
鐻	金 豦	釒 豦
鐼	金 賁	釒 賁
鐽	金 達	釒 達
鐿	金 意	釒 意
鑀	金 愛	釒 愛
鑁	金 囟 丶 丶 丶 丶 儿 夕	釒 囟 丶 丶 丶 丶 儿 夂
鑂	金 熏	釒 熏
鑃	金 翟	釒 翟
鑄	金 壽	釒 壽
鑅	金 榮	釒 榮
鑆	金 對	釒 對
鑇	金 齊	釒 齊
鑈	金 爾	釒 爾
鑉	金 蓋	釒 蓋
鑊	金 蒦	釒 蒦
鑋	輕 金
鑌	金 賓	釒 賓
鑍	賏 金
鑎	金 匱	釒 匱
鑏	金 寧	釒 寧
鑐	金 需	釒 需
鑑	金 監	釒 監
鑒	臣 丿 一 丶 网 金	臣 丿 一 丶 罒 金
鑔	金 察	釒 察
鑕	金 質	釒 質
鑖	金 蔑	釒 蔑
鑗	金 黎	釒 黎
鑘	金 畾	釒 畾
鑙	金 禾 尤 旨	釒 禾 尤 旨
鑚	金 賛	釒 賛
鑛	金 廣	釒 廣
鑜	金 賞	釒 賞
鑝	金 蓬	釒 蓬
鑞	金 巤	釒 巤
鑟	金 賣	釒 賣
鑠	金 樂	釒 樂
鑡	金 齒	釒 齒
鑢	金 慮	釒 慮
鑣	金 麃	釒 麃
鑤	金 暴	釒 暴
鑥	金 魯	釒 魯
鑨	金 龍	釒 龍
鑩	金 噩	釒 噩
鑪	金 盧	釒 盧
鑬	金 覽	釒 覽
鑭	金 闌	釒 闌
鑮	金 薄	釒 薄
鑯	金 韱	釒 韱
鑰	金 龠	釒 龠
鑱	金 毚	釒 毚
鑲	金 襄	釒 襄
鑳	金 蹇	釒 蹇
鑴	金 巂	釒 巂
鑵	金 雚	釒 雚
鑶	金 藏	釒 藏
鑷	金 聶	釒 聶
鑸	金 壘	釒 壘
鑹	金 竄	釒 竄
鑺	金 瞿	釒 瞿
鑻	金 攀	釒 攀
鑼	金 羅	釒 羅
鑽	金 贊	釒 贊
鑾	絲 言 金	糸 言 糸 金	䜌 金
鑿	丵 臼 殳 金
钀	金 獻	釒 獻
钁	金 矍	釒 矍
钂	金 黨	釒 黨
钃	金 屬	釒 屬
钄	金 蘭	釒 蘭
镹	長 久	镸 久
镺	長 夭	镸 夭
镻	長 失	镸 失
镼	長 屈	镸 屈
镽	長 尞	镸 尞
镾	長 爾	镸 爾
門	尸 一 匸 一 亅
閁	門 丿
閂	門 一
閃	門 人
閄	門 人
閅	門 丁
閆	門 三
閇	門 下
閈	門 干
閉	門 才
開	門 开
閌	門 亢
閍	門 方
閎	門 厷
閏	門 王
閐	門 毛
閑	門 木
閒	門 月
間	門 日
閔	門 文
閕	門 牙
閗	門 斗
閘	門 甲
閙	門 市
閛	門 平
閜	門 可
閝	門 令
閞	門 弁
閟	門 必
閠	門 玉
閡	門 亥
関	門 关
閣	門 各
閤	門 合
閥	門 伐
閦	門 众
閧	門 共
閨	門 圭
閩	門 蟲	門 虫
閫	門 困
閬	門 良
閭	門 呂
閮	門 廷
閯	門 沙
閰	門 臼
閱	門 兌
閲	門 兑
閳	門 車
閴	門 貝
閵	門 隹
閶	門 昌
閷	杀 閃
閸	門 亞
閹	門 奄
閺	門 旻
閻	門 臽
閼	門 於
閽	門 昏
閾	門 或
閿	門 受
闀	門 巷
闁	門 門
闂	門 卷
闃	門 狊
闄	門 要
闅	門 目 攴
闆	門 品
闇	門 音
闈	門 韋
闉	門 垔
闊	門 活
闋	門 癸
闌	門 柬
闍	門 者
闐	門 真
闑	門 臬
闒	門 日 羽
闓	門 豈
闔	門 盍
闕	門 欮
闖	門 馬
闗	門 絲
闘	門 豆 寸
闙	門 啟
闚	門 規
闛	門 堂
關	門 幺 幺 丱	門 幺 幺 卯
闝	門 敗
闞	門 敢
闟	門 翕
闠	門 貴
闡	門 單
闢	門 辟
闣	門 當
闤	門 睘
闥	門 達
闦	門 豊
陘	阜 巠	阝 巠
陜	阜 夾	阝 夾
陝	阜 大 入 入	阝 大 入 入
陞	阜 升 土	阝 升 土
陣	阜 車	阝 車
陥	阜 刀 旧	阝 刀 旧
陯	阜 侖	阝 侖
陰	阜 侌	阝 侌
陳	阜 東	阝 東
陸	阜 坴	阝 坴
険	阜 人 一 口 人	阝 人 一 口 人
陽	阜 昜	阝 昜
陿	阜 匧	阝 匧
隊	阜 丷 豕	阝 丷 豕
階	阜 皆	阝 皆
隑	阜 豈	阝 豈
隕	阜 員	阝 員
際	阜 祭	阝 祭
隝	阜 島	阝 島
隠	阜 爪 彐 心	阝 爫 彐 心
隢	阜 堯	阝 堯
隨	阜 遀	阝 遀	阜 辵 左 月
險	阜 僉	阝 僉
隫	阜 賁	阝 賁
隬	阜 爾	阝 爾
隮	阜 齊	阝 齊
隯	阜 壽	阝 壽
隰	阜 日 幺 幺 火	阝 日 幺 幺 灬	阜 㬎	阝 㬎
隱	阜 爪 工 彐 心	阝 爫 工 彐 心	阜 㥯	阝 㥯
隲	阜 少 馬	阝 少 馬
隴	阜 龍	阝 龍
隵	阜 戲	阝 戲
隸	木 示 隶
隻	隹 又
雈	草 隹	艸 隹	艹 隹
雋	隹 丨 ㇆ 一 丨 ㇆
雑	杂 隹
雖	虽 隹
雙	隹 隹 又
雛	芻 隹
雜	卒 八 隹
雞	奚 隹
離	离 隹
難	革 大 隹
雲	雨 云
電	雨 电
霢	雨 脈
霣	雨 員
霧	雨 務
霴	雲 隶
霽	雨 齊
靂	雨 歷
靄	雨 謁
靅	雲 費
靆	雲 逮
靇	雨 龍
靈	霝 巫
靉	雲 愛
靋	雨 瀝
靌	雨 寶
靎	雨 鵭
靏	雨 鶴
靑	丰 円	三 丨 円
靚	青 見
靜	青 爭
靝	青 氣
靦	面 見
靧	面 貴
靨	厭 面
鞏	巩 革
鞦	革 秋
鞸	革 畢
鞻	革 婁
鞼	革 貴
鞽	革 喬
鞾	革 華
鞿	革 幾
韁	革 畺
韃	革 達
韅	革 日 幺 幺 火	革 日 幺 幺 灬	革 㬎
韆	革 遷
韇	革 賣
韉	革 薦
韊	革 蘭
韋	彑 口 二 丶 丨
韌	韋 刃
韍	韋 犮
韎	韋 未
韏	丷 夫 韋	𠔉 韋
韐	韋 合
韑	光 韋
韒	韋 肖
韓	十 日 十 韋
韔	韋 長
韖	韋 柔
韗	韋 軍
韘	韋 枼
韙	是 韋
韚	韋 革
韛	韋 草 厂 用	韋 艸 厂 用	韋 艹 厂 用
韜	韋 舀
韞	韋 昷
韠	韋 畢
韡	韋 華
韢	韋 惠
韣	韋 蜀
韤	韋 蔑
韥	韋 賣
韲	亠 丫 刀 □ 韭
韻	音 員
響	鄉 音
頁	一 丶 貝
頂	丁 頁
頃	匕 頁
頄	九 頁
項	工 頁
順	川 頁
頇	干 頁
須	彡 頁
頉	止 頁
頊	玉 頁	王 頁
頋	厄 頁
頌	公 頁
頍	支 頁
頎	斤 頁
頏	亢 頁
預	予 頁
頑	元 頁
頒	分 頁
頓	屯 頁
頔	由 頁
頕	占 頁
頖	半 頁
頗	皮 頁
領	令 頁
頚	圣 頁
頛	耒 頁
頜	合 頁
頝	交 頁
頞	安 頁
頟	各 頁
頠	危 頁
頡	吉 頁
頢	舌 頁
頣	臣 頁
頤	匸 丨 口 丨 頁
頥	丨 頣
頦	亥 頁
頧	戶 乛 一 頁
頨	羽 頁
頩	并 頁	幷 頁
頪	米 頁
頬	夹 頁
頭	豆 頁
頮	水 廾 頁
頯	月 廾 頁
頰	夾 頁
頱	寽 頁
頲	廷 頁
頳	赤 頁
頴	匕 示 頁
頵	君 頁
頷	含 頁
頸	巠 頁
頹	禿 頁
頺	秀 頁
頻	步 頁
頼	束 頁
頽	秃 頁
頾	須 此
頿	彡 此 頁	須 此
顀	隹 頁
顁	定 頁
顂	來 頁
顃	炎 頁
顄	函 頁
顅	肩 頁
顆	果 頁
顈	匕 糸 頁
顉	金 頁	釒 頁
顊	阜 頁
顋	思 頁
題	是 頁
額	客 頁
顎	咢 頁
顏	彦 頁
顐	軍 頁
顑	咸 頁
顒	禺 頁
顓	耑 頁
顔	彥 頁
顕	显 頁
顖	囟 心 頁
顗	豈 頁
願	原 頁
顙	桑 頁
顚	眞 頁
顛	真 頁
顜	冓 頁
顝	骨 頁
類	类 頁
顟	翏 頁
顠	票 頁
顡	豙 頁
顢	廿 冂 丨 入 入 頁	㒼 頁
顣	戚 頁
顤	堯 頁
顥	景 頁
顦	焦 頁
顧	雇 頁
顨	頁 頁 丌
顩	僉 頁
顪	歲 頁
顫	亶 頁
顬	需 頁
顭	夢 頁
顮	賓 頁
顯	日 幺 幺 火 頁	日 幺 幺 灬 頁	㬎 頁
顰	頻 卑
顱	盧 頁
顲	炎 亠 回 頁
顳	聶 頁
顴	雚 頁
風	几 一 蟲	几 一 虫
颩	風 彡
颫	風 夫
颬	風 牙
颭	風 占
颮	風 包
颯	立 風
颰	風 犮
颱	風 台
颲	風 列
颳	風 舌
颴	風 丿 一 疋
颵	風 肖
颶	風 具
颷	風 炎
颸	風 思
颹	風 韋
颺	風 昜
颻	月 缶 風	䍃 風
颼	風 叟
颽	豈 風
颾	風 蚤
颿	馬 風
飀	風 留
飁	習 風
飂	風 翏
飃	風 票
飄	票 風
飅	風 畱
飆	猋 風	犬 犬 犬 風
飇	風 猋
飈	風 焱
飉	風 尞
飋	風 瑟
飌	雚 風
飛	飞 升 飞
飠	人 良
飢	食 几	飠 几
飣	食 丁
飤	食 人
飥	食 乇
飦	食 干
飧	夕 食
飩	食 屯	飠 屯
飪	食 壬	飠 壬
飫	食 夭
飭	食 丿 一 力
飮	食 欠
飯	食 反	飠 反
飰	食 卞
飱	歹 食
飲	食 欠	飠 欠
飳	食 主
飴	食 台	飠 台
飵	食 乍
飶	食 必
飷	食 且
飹	食 卯
飻	食 人 彡
飼	食 司	飠 司
飽	食 包	飠 包
飾	食 丿 一 巾	飠 丿 一 巾	食 布
飿	食 出
餁	食 任
餂	食 舌
餃	食 交	飠 交
餄	食 合	飠 合
餅	食 并	飠 并	食 幷	飠 幷
餆	食 兆
餇	食 同
餉	食 向	飠 向
養	羊 食
餋	丷 夫 食	𠔉 食
餌	食 耳	飠 耳
餎	食 各	飠 各
餏	食 衣
餑	食 孛
餒	食 妥	飠 妥
餓	食 我	飠 我
餔	食 甫
餕	食 夋
餖	食 豆
餗	食 束
餘	食 余	飠 余
餘	食 余
餙	食 希
餚	食 肴	飠 肴
餛	食 昆	飠 昆
餜	食 果
餝	食 芳
餞	食 戔	飠 戔
餟	食 叕
餠	食 幷	飠 幷	食 并	飠 并
餡	食 臽	飠 臽
餢	食 咅
餣	食 奄
餤	食 炎
餦	食 長
餧	食 委
館	食 官	飠 官
餩	食 八 亥
餪	食 耎
餫	食 軍
餬	食 胡	飠 胡
餭	食 皇
餯	食 彖
餰	食 衍
餱	食 侯
餲	食 曷
餳	食 昜
餴	食 奔
餵	食 畏	飠 畏
餶	食 骨
餷	食 查
餸	食 送	飠 送
餹	食 唐
餺	食 尃
餻	食 羔
餼	食 氣	飠 氣
餽	食 鬼
餾	食 留	飠 留
餿	食 叟	飠 叟
饀	食 舀
饁	食 盍
饂	食 昷
饃	食 莫	飠 莫
饄	食 堂
饅	食 曼	飠 曼
饆	食 畢
饇	食 區
饈	食 羞
饉	食 堇
饊	食 散
饋	食 貴	飠 貴
饌	食 巽	飠 巽
饍	食 善
饎	食 喜
饐	食 壹
饑	食 幾
饒	食 堯	飠 堯
饓	食 棠
饔	雍 食
饖	食 歲
饗	鄉 食
饘	食 亶
饙	食 賁
饛	食 蒙
饜	厭 食
饝	食 磨
饞	食 毚	飠 毚
饟	食 襄
饠	食 羅
饡	食 贊
饢	食 囊
馢	香 戔
馩	香 賁
馪	香 賓
馭	馬 又
馮	冰 馬	冫 馬
馰	馬 勺
馱	馬 大
馲	馬 乇
馳	馬 也
馴	馬 川
馵	馬 廾
馶	馬 支
馷	馬 巿
馸	馬 斤
馹	馬 日
馺	馬 及
馻	馬 允
馼	馬 文
馽	馬 中
馿	馬 戶
駀	馬 尤
駁	馬 爻
駂	馬 匕 十	馬 𠤏
駃	馬 夬
駄	馬 太
駅	馬 尺
駆	馬 区
駈	馬 丘
駉	馬 冋
駊	馬 皮
駋	馬 召
駌	夗 馬
駍	馬 平
駎	馬 由
駏	馬 巨
駐	馬 主
駑	奴 馬
駒	馬 句
駓	馬 丕
駔	馬 且
駕	加 馬
駖	馬 令
駗	馬 人 彡
駘	馬 台
駙	馬 付
駚	馬 央
駛	馬 史
駜	馬 必
駝	馬 它
駞	馬 丿 一 也
駟	馬 四
駠	馬 卯
駡	口 口 馬
駢	馬 并	馬 幷
駣	馬 兆
駤	馬 至
駥	馬 戎
駦	丷 夫 馬	𠔉 馬
駧	馬 同
駨	馬 旬
駩	馬 全
駪	馬 先
駫	馬 光
駬	馬 耳
駭	馬 亥
駮	馬 交
駰	馬 因
駱	馬 各
駳	馬 延
駴	馬 戒
駵	馬 丣
駶	馬 局
駷	馬 束
駸	馬 彐 冖 又
駹	馬 尨
駺	馬 良
駻	馬 旱
駼	馬 余
駽	馬 肙
駾	馬 兌
駿	馬 夋
騀	馬 我
騁	馬 甹	馬 由 丂
騂	馬 辛
騃	馬 矣
騄	馬 彔
騅	馬 隹
騆	馬 周
騇	馬 舍
騈	馬 幷
騉	馬 昆
騊	馬 匋
騋	馬 來
騌	馬 宗
騍	馬 果
騎	馬 奇
騏	馬 其
騐	馬 念
騒	馬 又 蟲	馬 又 虫
験	馬 人 一 口 人
騔	馬 曷
騕	馬 要
騖	敄 馬
騗	扁 馬
騘	馬 怱
騙	馬 扁
騚	馬 前
騜	馬 皇
騝	馬 建
騞	馬 砉
騟	馬 俞
騠	馬 是
騡	馬 泉
騢	馬 叚
騣	馬 凶 八 夕	馬 凶 八 夂
騤	馬 癸
騥	馬 柔
騦	馬 思
騧	馬 咼
騨	馬 单 丶
騩	馬 鬼
騪	馬 叟
騫	馬 宀 井 大
騬	馬 乘
騭	陟 馬
騮	馬 留
騯	馬 旁
騰	肉 駦	月 駦
騱	馬 奚
騲	馬 草
騴	馬 妟
騵	馬 原
騶	馬 芻
騷	馬 蚤
騸	馬 扇
騹	馬 堇
騺	執 馬
騻	馬 爽
騼	馬 鹿
騽	馬 習
騾	馬 累
騿	馬 章
驀	莫 馬
驁	敖 馬
驂	馬 參
驃	馬 票
驄	馬 悤
驅	馬 區
驆	馬 畢
驇	埶 馬
驈	馬 矞
驉	馬 虛
驊	馬 華
驋	馬 發
驌	馬 肅
驍	馬 堯
驎	馬 粦
驏	馬 孱
驐	馬 敦
驑	馬 畱
驒	馬 單
驓	馬 曾
驔	馬 覃
驕	馬 喬
驖	馬 哉 王
驗	馬 僉
驘	亡 口 月 馬 凡
驙	馬 亶
驚	馬 敬
驛	馬 睪
驜	馬 業
驝	馬 槖
驞	馬 賓
驟	馬 聚
驠	馬 燕
驡	龍 馬
驢	馬 盧
驣	馬 駦
驤	馬 襄
驥	馬 冀
驦	馬 霜
驧	馬 鞠
驨	馬 巂
驩	馬 雚
驪	馬 麗
驫	馬 馬 馬
骯	骨 亢
髏	骨 婁
髐	骨 堯
髑	骨 蜀
髒	骨 葬
體	骨 豊
髕	骨 賓
髖	骨 寬
髗	骨 盧
髝	高 勞
髮	髟 犮
鬆	髟 松
鬍	髟 胡
鬗	髟 廿 冂 丨 入 入	髟 㒼
鬚	髟 须
鬜	髟 閒
鬝	髟 間
鬞	髟 農
鬠	髟 會
鬡	髟 寧
鬢	髟 賓
鬥	丨 王 王 亅
鬦	鬥 斗
鬧	鬥 市
鬨	鬥 共
鬩	鬥 兒
鬪	鬥 豆 寸
鬬	鬥 斵
鬭	鬥 斲
鬮	鬥 龜
鬱	木 缶 木 冖 鬯 彡
鬹	規 鬲
魎	鬼 兩
魓	鬼 畢
魕	鬼 幾
魗	鬼 壽
魘	厭 鬼
魚	刀 田 火	刀 田 灬
魛	魚 刀
魜	魚 人
魝	魚 刀	魚 刂
魟	魚 工
魠	魚 乇
魡	魚 勺
魢	魚 己
魣	魚 予
魤	魚 化
魥	魚 及
魦	魚 少
魧	魚 亢
魨	魚 屯
魩	魚 勿
魪	魚 介
魫	魚 冘
魬	魚 反
魭	魚 元
魮	魚 比
魯	魚 日
魰	魚 文
魱	魚 互
魲	魚 戶
魳	魚 帀
魴	魚 方
魵	魚 分
魶	魚 內
魷	魚 尤
魺	魚 可
魻	魚 甲
魼	魚 去
魽	魚 甘
魾	魚 丕
魿	魚 令
鮀	魚 它
鮁	魚 犮
鮂	魚 囚
鮃	魚 平
鮄	魚 弗
鮅	魚 必
鮆	此 魚
鮇	魚 未
鮈	魚 句
鮉	魚 召
鮊	魚 白
鮋	魚 由
鮌	魚 玄
鮍	魚 皮
鮎	魚 占
鮏	魚 生
鮐	魚 台
鮑	魚 包
鮒	魚 付
鮓	魚 乍
鮔	魚 巨
鮕	魚 古
鮙	魚 羽
鮚	魚 吉
鮛	魚 尗
鮜	魚 后
鮝	丷 夫 魚	𠔉 魚
鮞	魚 而
鮟	魚 安
鮠	魚 危
鮡	魚 兆
鮢	魚 朱
鮣	魚 印
鮤	列 魚
鮥	魚 各
鮦	魚 同
鮧	魚 夷
鮨	魚 旨
鮩	魚 并	魚 幷
鮪	魚 有
鮫	魚 交
鮬	魚 夸
鮭	魚 圭
鮮	魚 羊
鮯	魚 合
鮰	魚 回
鮳	魚 考
鮵	魚 兌
鮶	魚 君
鮷	魚 弟
鮸	魚 免
鮹	魚 肖
鮺	羊 魚
鮻	魚 夋
鮼	魚 彐 冖 又
鮽	魚 余
鮾	魚 妥
鮿	魚 耴
鯀	魚 系
鯁	魚 更
鯃	魚 吾
鯄	魚 求
鯅	魚 延
鯆	魚 甫
鯇	魚 完
鯈	攸 魚
鯉	魚 里
鯊	沙 魚
鯋	魚 沙
鯌	魚 告
鯍	魚 亠 厶 川	魚 巟	魚 㐬
鯒	魚 甬
鯓	魚 身
鯔	魚 甾
鯕	魚 其
鯖	魚 青
鯗	羊 八 魚
鯘	魚 委
鯙	魚 享
鯚	魚 季
鯛	魚 周
鯜	魚 妾
鯝	魚 固
鯞	魚 帚
鯟	魚 東
鯠	魚 來
鯡	魚 非
鯢	魚 兒
鯣	魚 易
鯤	魚 昆
鯥	魚 坴
鯦	魚 咎
鯧	魚 昌
鯨	魚 京
鯩	魚 侖
鯪	魚 夌
鯫	魚 取
鯬	禾 勹 丿 魚
鯭	魚 孟
鯮	魚 宗
鯯	魚 制
鯰	魚 念
鯴	魚 虱
鯵	魚 參
鯶	魚 軍
鯷	魚 是
鯸	魚 侯
鯹	魚 星
鯺	魚 者
鯻	魚 剌
鯼	魚 凶 八 夕	魚 凶 八 夂
鯽	魚 即
鯾	魚 便
鯿	魚 扁
鰀	魚 爰
鰁	魚 泉
鰂	魚 則
鰃	魚 畏
鰄	魚 威
鰅	魚 禺
鰆	魚 春
鰇	魚 柔
鰈	魚 枼
鰉	魚 皇
鰊	魚 柬
鰋	魚 匽
鰌	魚 酋
鰍	魚 秋
鰎	魚 建
鰏	魚 畐
鰐	魚 咢
鰑	魚 昜
鰒	魚 复
鰓	魚 思
鰔	魚 咸
鰕	魚 叚
鰖	魚 左 月
鰗	魚 胡
鰙	魚 若
鰛	魚 昷
鰜	魚 兼
鰝	魚 高
鰞	魚 烏
鰟	魚 旁
鰠	魚 蚤
鰡	魚 留
鰢	魚 馬
鰣	魚 時
鰤	魚 師
鰥	魚 眔
鰧	肉 鮝	月 鮝
鰨	魚 日 羽
鰩	魚 月 缶	魚 䍃
鰪	魚 盍
鰫	魚 容
鰬	魚 虔
鰭	魚 耆
鰮	魚 昷
鰯	魚 弱
鰱	魚 連
鰲	敖 魚
鰳	魚 勒
鰴	彳 山 一 魚 攴	彳 山 一 魚 攵
鰵	敏 魚
鰶	魚 祭
鰷	魚 條
鰸	魚 區
鰹	魚 堅
鰺	魚 參
鰻	魚 曼
鰼	魚 習
鰽	魚 曹
鰾	魚 票
鰿	魚 責
鱀	既 魚
鱁	魚 逐
鱂	魚 將
鱃	魚 羞
鱄	魚 專
鱅	魚 庸
鱆	魚 章
鱇	魚 康
鱈	魚 雪
鱉	魚 敝
鱊	魚 矞
鱋	魚 虛
鱌	魚 象
鱍	魚 發
鱎	魚 喬
鱏	魚 覃
鱐	魚 肅
鱑	魚 黃
鱒	魚 尊
鱓	魚 單
鱔	魚 善
鱕	魚 番
鱖	魚 厥
鱗	魚 粦
鱘	魚 尋
鱙	魚 堯
鱚	魚 喜
鱝	魚 賁
鱞	魚 睘
鱟	臼 爻 冖 魚	𦥯 魚
鱠	魚 會
鱡	魚 賊
鱢	魚 喿
鱣	魚 亶
鱤	魚 感
鱥	魚 歲
鱦	魚 黽
鱧	魚 豊
鱨	魚 嘗
鱬	魚 需
鱭	魚 齊
鱮	魚 與
鱯	魚 蒦
鱱	魚 厲
鱲	魚 巤
鱳	魚 樂
鱴	魚 蔑
鱵	魚 箴
鱶	魚 養
鱷	魚 噩
鱸	魚 盧
鱹	魚 雚
鱺	魚 麗
鱻	魚 魚 魚
鳥	户 一 一 ㇆ 火	户 一 一 ㇆ 灬
鳦	鳥 乙
鳧	鳥 几
鳨	鳥 力
鳩	九 鳥
鳫	厂 鳥
鳬	户 一 一 ㇆ 几
鳮	又 鳥
鳯	几 鳥
鳱	干 鳥
鳲	尸 鳥
鳳	几 一 鳥
鳴	口 鳥
鳵	卂 鳥
鳶	弋 鳥
鳷	支 鳥
鳸	戶 鳥
鳹	今 鳥
鳺	夫 鳥
鳻	分 鳥
鳼	文 鳥
鳽	开 鳥
鳾	帀 鳥
鳿	玉 鳥	王 鳥
鴀	不 鳥
鴁	夭 鳥
鴂	夬 鳥
鴃	鳥 夬
鴄	匹 鳥
鴅	丹 鳥
鴆	冘 鳥
鴇	匕 十 鳥	𠤏 鳥
鴈	厂 人 鳥	厂 亻 鳥
鴉	牙 鳥
鴊	正 鳥
鴋	方 鳥
鴌	天 鳥
鴍	文 鳥
鴎	区 鳥
鴐	加 鳥
鴑	奴 鳥
鴒	令 鳥
鴓	必 鳥
鴔	乏 鳥
鴕	鳥 它
鴖	民 鳥
鴗	立 鳥
鴘	弁 鳥
鴙	矢 鳥
鴚	鳥 可
鴛	夗 鳥
鴜	此 鳥
鴝	句 鳥
鴞	号 鳥
鴟	氐 鳥
鴡	且 鳥
鴢	幼 鳥
鴣	古 鳥
鴤	鳥 冬
鴥	鳥 穴
鴦	央 鳥
鴧	宂 鳥
鴨	甲 鳥
鴩	失 鳥
鴪	穴 鳥
鴬	小 冖 鳥
鴭	戶 乛 一 鳥	户 乛 一 鳥
鴮	烏 鳥
鴯	而 鳥
鴰	舌 鳥
鴱	艾 鳥
鴲	旨 鳥
鴳	安 鳥
鴴	行 鳥
鴵	兆 鳥
鴶	吉 鳥
鴷	列 鳥
鴸	朱 鳥
鴹	羊 鳥
鴺	夷 鳥
鴻	水 工 鳥	氵 工 鳥
鴼	鳥 各
鴽	如 鳥
鴾	牟 鳥
鴿	合 鳥
鵀	任 鳥
鵁	交 鳥
鵂	休 鳥
鵃	舟 鳥
鵄	至 鳥
鵅	各 鳥
鵉	亦 鳥
鵊	夾 鳥
鵋	忌 鳥
鵌	余 鳥
鵍	完 鳥
鵎	妥 鳥
鵏	甫 鳥
鵐	巫 鳥
鵑	肙 鳥
鵒	谷 鳥
鵓	孛 鳥
鵔	鳥 夋
鵕	夋 鳥
鵖	皂 鳥
鵗	希 鳥
鵘	君 鳥
鵙	貝 鳥
鵚	禿 鳥
鵛	巠 鳥
鵜	弟 鳥
鵝	我 鳥
鵞	我 鳥
鵟	狂 鳥
鵠	告 鳥
鵡	武 鳥
鵢	身 鳥
鵣	束 鳥
鵦	录 鳥
鵧	并 鳥	幷 鳥
鵨	舍 鳥
鵩	服 鳥
鵪	奄 鳥
鵫	卓 鳥
鵬	朋 鳥
鵭	金 鳥	釒 鳥
鵮	臽 鳥
鵯	卑 鳥
鵰	周 鳥
鵱	坴 鳥
鵲	昔 鳥
鵳	肩 鳥
鵴	匊 鳥
鵵	兔 鳥
鵶	亞 鳥
鵷	宛 鳥
鵸	奇 鳥
鵹	禾 勹 丿 鳥
鵺	夜 鳥
鵻	鳥 隹
鵼	空 鳥
鵽	叕 鳥
鵾	昆 鳥
鵿	鳥 昇
鶀	鳥 其
鶁	京 鳥
鶂	兒 鳥
鶃	鳥 兒
鶄	青 鳥
鶅	甾 鳥
鶆	來 鳥
鶇	東 鳥
鶈	妻 鳥
鶉	享 鳥
鶊	庚 鳥
鶋	居 鳥
鶌	屈 鳥
鶏	爪 夫 鳥	爫 夫 鳥
鶐	述 鳥
鶒	勅 鳥
鶓	苗 鳥
鶔	柔 鳥
鶕	音 鳥
鶖	秋 鳥
鶗	是 鳥
鶘	胡 鳥
鶙	帝 鳥
鶚	咢 鳥
鶛	皆 鳥
鶜	茅 鳥
鶝	畐 鳥
鶞	盾 鳥
鶟	突 鳥
鶠	匽 鳥
鶡	曷 鳥
鶢	爰 鳥
鶣	扁 鳥
鶤	軍 鳥
鶥	眉 鳥
鶦	胡 鳥
鶧	英 鳥
鶨	彖 鳥
鶩	敄 鳥
鶪	狊 鳥
鶬	倉 鳥
鶭	紡 鳥
鶮	高 鳥
鶯	火 火 冖 鳥	𤇾 鳥
鶰	員 鳥
鶱	宀 井 大 鳥
鶲	翁 鳥
鶳	鳥 師
鶴	隺 鳥
鶵	芻 鳥
鶶	唐 鳥
鶷	害 鳥
鶸	弱 鳥
鶹	留 鳥
鶺	脊 鳥
鶻	骨 鳥
鶼	兼 鳥
鶽	隼 鳥
鶾	十 日 十 丿 一 鳥
鶿	兹 鳥
鷀	兹 鳥
鷁	益 鳥
鷂	爪 缶 鳥	爫 缶 鳥
鷃	妟 鳥
鷄	奚 鳥
鷅	栗 鳥
鷆	眞 鳥
鷇	士 冖 一 鳥 殳
鷈	鳥 虒
鷉	虒 鳥
鷊	鬲 鳥
鷋	荼 鳥
鷌	鳥 馬
鷍	臬 鳥
鷏	真 鳥
鷑	笠 鳥
鷒	專 鳥
鷓	庶 鳥
鷔	敖 鳥
鷕	唯 鳥
鷖	殹 鳥
鷗	區 鳥
鷘	敕 鳥
鷙	執 鳥
鷚	翏 鳥
鷛	庸 鳥
鷜	婁 鳥
鷝	畢 鳥
鷞	爽 鳥
鷟	族 鳥
鷠	魚 鳥
鷡	無 烏
鷢	厥 鳥
鷣	覃 鳥
鷤	單 鳥
鷥	絲 鳥
鷦	焦 鳥
鷧	壹 鳥
鷨	華 鳥
鷩	敝 鳥
鷪	目 目 冖 鳥
鷫	肅 鳥
鷬	黃 鳥
鷭	番 鳥
鷮	喬 鳥
鷯	尞 鳥
鷰	廿 北 口 鳥
鷱	臯 鳥
鷲	就 鳥
鷳	閒 鳥
鷴	閑 鳥
鷵	屠 鳥
鷶	買 鳥
鷷	尊 鳥
鷸	矞 鳥	矛 冏 鳥
鷹	广 人 隹 鳥	广 亻 隹 鳥	广 倠 鳥
鷺	路 鳥
鷻	鳥 敦
鷼	間 鳥
鷽	臼 爻 冖 鳥	𦥯 鳥
鷾	意 鳥
鷿	辟 鳥
鸀	蜀 鳥
鸁	亡 口 月 鳥 凡
鸂	水 鷄	氵 鷄
鸃	鳥 義
鸄	敫 鳥
鸅	睪 鳥
鸆	虞 鳥
鸇	亶 鳥
鸈	業 鳥
鸉	楊 鳥
鸊	辟 鳥
鸋	寧 鳥
鸌	鳥 蒦
鸍	爾 鳥
鸎	賏 鳥
鸏	蒙 鳥
鸐	翟 鳥
鸑	獄 鳥
鸒	與 鳥
鸓	畾 鳥
鸔	鳥 暴
鸕	盧 鳥
鸖	霍 鳥
鸗	龍 鳥
鸘	霜 鳥
鸙	龠 鳥
鸚	嬰 鳥
鸛	雚 鳥
鸜	瞿 鳥
鸝	麗 鳥
鸞	絲 言 鳥	糸 言 糸 鳥	䜌 鳥
鹵	卜 囗 丰
鹶	鹵 今
鹷	鹵 令
鹸	鹵 人 一 口 人
鹹	鹵 咸
鹺	鹵 差
鹻	鹵 兼
鹼	鹵 僉
鹽	臣 丿 一 鹵 皿
麗	丽 鹿
麡	鹿 齊
麥	來 夕	來 夂
麩	麥 夫
麪	麥 丐
麬	麥 皮
麭	麥 包
麮	麥 去
麯	麥 曲
麰	麥 牟
麱	麥 甫
麳	麥 來
麴	麥 匊	麥 勹 米
麴	麥 匊
麵	麥 面
麵	麥 面
麷	麥 豐
麼	麻 幺
麽	麻 么
黂	麻 賁
黃	廿 一 田 八
黈	黃 主
黊	黃 圭
黋	黃 光
黌	臼 爻 冖 黃	𦥯 黃
黒	里 火	里 灬
點	黑 占
黨	尚 黑
黲	黑 參
黴	彳 山 一 黑 攴	彳 山 一 黑 攵
黶	壓 黑
黷	黑 賣
黸	黑 盧
黽	冂 一
黿	元 黽
鼁	去 黽
鼂	旦 黽
鼉	口 口 田 一 黽
鼘	鼓 片 一 爿
鼚	鼓 長
鼡	小 用
鼰	鼠 貝
鼲	鼠 軍
鼴	鼠 匽
齈	鼻 農
齊	亠 刀 丫 □ 丿 丨 二
齋	齊 小
齍	齊 皿
齎	齊 貝
齏	亠 丫 刀 □ 丿 丨 二 韭
齒	止 人 人 凵 一 人 人
齓	齒 乚
齔	齒 匕
齕	齒 乞
齖	齒 牙
齗	齒 斤
齘	齒 介
齙	齒 包
齚	齒 乍
齛	齒 世
齜	齒 此
齝	齒 台
齞	齒 只
齟	齒 且
齠	齒 召
齡	齒 令
齢	歯 令
齣	齒 句
齤	丷 夫 齒	𠔉 齒
齥	齒 曳
齦	齒 艮
齧	丰 刀 齒
齨	齒 臼
齩	齒 交
齪	齒 足
齫	齒 困
齬	齒 吾
齭	齒 所
齮	齒 奇
齯	齒 兒
齰	齒 昔
齱	齒 取
齲	齒 禹
齳	齒 軍
齴	齒 彦
齵	齒 禺
齶	齒 咢
齷	齒 屋
齸	齒 益
齹	差 齒
齺	齒 芻
齻	齒 真
齼	齒 楚
齽	齒 禁
齾	獻 齒
龍	立 月 一 𠃑 一 乚 三
龎	厂 龍
龏	龍 廾
龐	广 龍
龑	龍 天
龒	龍 示
龓	有 龍
龔	龍 共
龕	合 龍
龖	龍 龍
龗	霝 龍
龘	龍 龍 龍
龜	刀 □ 丨 乚 彐 彐 囗 乂
龝	禾 龜
龞	敝 龜
龥	龠 頁
㓨	夾 刀	夾 刂
䰾	魚 巴
䲁	魚 尉
䲘	魚 管
䴉	睘 鳥
䀹	目 夾
閪	門 西
㒓	人 達	亻 達
㘘	絲 言 口	糸 言 糸 口	䜌 口
㧿	手 從	扌 從	才 從
㨥	手 納	扌 納	才 納
䁪	目 斬
䈫	竹 納
䘆	蟲 憲	虫 憲
䛿	言 鬲
䭔	食 追	飠 追
䳍	共 鳥
𠺪	口 氣
𠼮	口 僞
𠾍	口 棄
𡁜	口 禍
𡁯	口 奪
𡁵	口 緊
𡁻	口 趙
𡃁	口 靚
𡃴	口 隨
𡃶	口 錫
𡄽	口 瀉
𢝵	飛 心
𢞵	飛 必
𢮊	手 軋	扌 軋	才 軋
𢯩	手 則	扌 則	才 則
𢯷	手 韋	扌 韋	才 韋
𢰨	恆 手
𢰸	手 咼	扌 咼	才 咼
𢰹	手 約	扌 約	才 約
𢰺	手 負	扌 負	才 負
𢱚	手 風	扌 風	才 風
𢷮	扌 對	扌 對	才 對
𢺋	難 手
𢺳	手 蠻	扌 蠻	才 蠻
𤓓	火 羅
𧊅	蟲 另	虫 另
𧋦	蟲 尾	虫 尾
𧕴	難 蟲	難 虫
𧢝	厲 見
𧥺	言 勻
𧬪	言 運
𨆪	輕 足
𨋢	車 立
𨳊	門 九
𨳍	門 七
𨳒	門 小
𨶙	門 能
𩓙	匕 矢 頁
𩓥	岳 頁
𩗴	風 奉
	口 賴
𧩙	言 廴 旦
𩶘	魚 立
